domain,task_name,requirements,types,objects,predicates,functions,init,goal,actions,axioms,use_min_cost_metric,generated_rules,relevant_atoms,auxiliary_atoms,final_queue_length,total_queue_pushes,implied_effects_removed,effect_conditions_simplified,implied_preconditions_added,translator_variables,translator_derived_variables,translator_facts,translator_mutex_groups,translator_total_mutex_groups_size,translator_operators,translator_task_size,numberVariablesCG,highLevelVariablesCG,totalEdgesCG,totalWeightCG,veRatio,weRatio,wvRatio,hvRatio,inputEdgeCGMax,inputEdgeCGAvg,inputEdgeCGStd,outputEdgeCGMax,outputEdgeCGAvg,outputEdgeCGStd,inputWeightCGMax,inputWeightCGAvg,inputWeightCGStd,outputWeightCGMax,outputWeightCGAvg,outputWeightCGStd,inputEdgeHVMax,inputEdgeHVAvg,inputEdgeHVStd,outputEdgeHVMax,outputEdgeHVAvg,outputEdgeHVStd,inputWeightHVMax,inputWeightHVAvg,inputWeightHVStd,outputWeightHVMax,outputWeightHVAvg,outputWeightHVStd,numberVariablesDTG,totalEdgesDTG,totalWeigthDTG,edVaRatioDTG,weEdRatioDTG,weVaRatioDTG,inputEdgeDTGMax,inputEdgeDTGAvg,inputEdgeDTGStd,outputEdgeDTGMax,outputEdgeDTGAvg,outputEdgeDTGStd,inputWeightDTGMax,inputWeightDTGAvg,inputWeightDTGStd,outputWeightDTGMax,outputWeightDTGAvg,outputWeightDTGStd,no,file,num_relevant_facts,num_actions,h_max,h_ff,h_ff_ratio,rp_fact_balance_min,rp_fact_balance_avg,rp_fact_balance_var,rp_goal_balance_min,rp_goal_balance_avg,rp_goal_balance_var,balance_Ratio,Unbalance_Ratio,Balance_Distorsion,Additive ,Blind,Causal_graph,Context-enhanced_additive,FF,Goal_count,Landmark_count,Landmark-cut,Max,n_landmarks,numberEdges,edVaratioLand,numberFatherNodes,numberChildrenNodes,nodosbetween,avginput,maxinput,stdinput,avgoutput,maxoutput,stdoutput,blackVariables,blackRootVariables,redBlackVariables,allpairsvaluesconnected,allvaluesconnectedgoal,blackstronglpyarents,Maximaleffectsblack,Hred-black,problem_name
child-snack,prob-snack,2,7,14,14,0,14,2,6,0,0,41,127,102,229,269,0,20,0,12,0,34,8,24,46,276,12,2,46,102,0.26087,2.21739,8.5,0.166667,7,3.83333,2.33928,7,3.83333,2.15381,15,8.5,5.28362,18,8.5,5.93717,0,0,0,12,1.66667,3.81517,0,0,0,12,1.66667,3.81517,34,66,148,0.445946,0.515152,1,3,1.85,0.264619,3,1.35,0.0,3,1.85,0.264619,3,1.35,0.0,1, /home/tomas/GitRepos/Gitforks/hapori/benchmarks/childsnack-strips/0-p01.pddl,24,54,3,5,1.666667,-1,-0.041667,0.610953,1,1.0,0.0,3.148148,0.0,1,9,1,9,9,6,2,6,5,3,10,14,1.4,6,2,2,1.4,3,0.0,1.4,7,2,2,2,12,2,0,0,0,5,0-p01.pddl
child-snack,prob-snack,2,7,18,14,0,21,3,6,0,0,41,192,138,330,416,0,78,0,17,0,47,11,32,87,582,17,3,99,354,0.171717,3.57576,20.8235,0.176471,10,5.82353,3.58486,9,5.82353,2.54917,36,20.8235,14.1888,38,20.8235,11.9619,0,0,0,18,2.82353,6.21417,0,0,0,18,2.82353,6.21417,47,153,423,0.361702,0.30719,1,6,2.82353,0.0,4,1.94118,0.0,6,2.82353,0.0,4,1.94118,0.0,1, /home/tomas/GitRepos/Gitforks/hapori/benchmarks/childsnack-strips/0-p02.pddl,32,95,3,7,2.333333,-2,-0.03125,0.728199,1,1.0,0.0,2.147368,0.252632,5,14,1,14,14,8,3,6,7,3,9,8,0.888889,6,3,0,0.888889,2,0.0,0.888889,3,1,2,2,17,2,0,0,0,7,0-p02.pddl
child-snack,prob-snack,2,7,22,14,0,28,4,6,0,0,41,293,174,467,649,0,200,0,22,0,60,14,40,164,1150,22,4,172,860,0.127907,5.0,39.0909,0.181818,13,7.81818,4.83958,11,7.81818,2.88627,68,39.0909,28.0404,66,39.0909,20.8565,0,0,0,24,4.0,8.61289,0,0,0,24,4.0,8.61289,60,300,896,0.334821,0.2,1,6,3.90909,0.0,5,3.18182,0.0,6,3.90909,0.0,5,3.18182,0.0,1, /home/tomas/GitRepos/Gitforks/hapori/benchmarks/childsnack-strips/0-p03.pddl,40,172,3,7,2.333333,-3,-0.025,0.688749,1,1.0,0.0,1.430233,0.0,3,19,1,19,19,8,4,6,7,3,10,11,1.1,6,4,0,1.1,4,1.0,1.1,3,1,2,2,22,2,0,0,0,7,0-p03.pddl
child-snack,prob-snack,2,7,26,14,0,35,5,6,0,0,41,442,210,652,998,0,410,0,27,0,73,17,48,289,2070,27,5,265,1710,0.101887,6.45283,63.3333,0.185185,16,9.81481,6.09819,13,9.81481,3.18605,110,63.3333,46.8053,102,63.3333,32.7957,0,0,0,30,5.18519,11.0119,0,0,0,30,5.18519,11.0119,73,559,1729,0.323308,0.13059,1,13,5.25926,0.0,13,4.98148,0.0926612,34,6.59259,0.0,34,6.31481,0.0926612,1, /home/tomas/GitRepos/Gitforks/hapori/benchmarks/childsnack-strips/0-p04.pddl,48,297,3,9,3.0,-4,-0.020833,0.803367,1,1.0,0.0,0.996633,0.094276,7,24,1,24,24,10,5,7,9,3,12,10,0.833333,7,5,0,0.833333,4,0.0,0.833333,2,0,2,2,27,2,0,0,0,9,0-p04.pddl
child-snack,prob-snack,2,7,30,14,0,40,6,6,0,0,41,595,244,839,1327,0,624,0,32,0,86,20,56,420,2988,32,6,360,2484,0.0888889,6.9,77.625,0.1875,19,11.25,7.3357,15,11.25,3.64863,144,77.625,59.1744,126,77.625,42.7681,0,0,0,36,6.0,12.7279,0,0,0,36,6.0,12.7279,86,888,2724,0.325991,0.0968468,1,26,7.8375,0.0,26,7.65,0.0,86,16.8375,0.0,86,16.65,0.0,1, /home/tomas/GitRepos/Gitforks/hapori/benchmarks/childsnack-strips/0-p05.pddl,56,428,3,11,3.666667,-5,-0.017857,0.915951,1,1.0,0.0,0.897196,0.140187,11,28,1,28,28,12,6,9,11,3,15,12,0.8,9,6,0,0.8,3,0.0,0.8,2,0,2,2,32,2,0,0,0,11,0-p05.pddl
child-snack,prob-snack,2,7,34,14,0,47,7,6,0,0,41,853,280,1133,1929,0,1036,0,37,0,99,23,64,654,4696,37,7,490,4081,0.0755102,8.32857,110.297,0.189189,22,13.2432,8.60046,17,13.2432,3.91398,203,110.297,85.4267,174,110.297,59.7806,0,0,0,42,7.18919,15.1351,0,0,0,42,7.18919,15.1351,99,1382,4301,0.321321,0.0716353,1,39,11.3054,0.159956,39,11.2108,0.0799779,138,29.5243,0.159956,138,29.4297,0.0799779,1, /home/tomas/GitRepos/Gitforks/hapori/benchmarks/childsnack-strips/0-p06.pddl,64,662,3,12,4.0,-6,-0.015625,0.960016,1,1.0,0.0,0.682779,0.096677,12,33,1,33,33,13,7,10,12,3,17,14,0.823529,10,7,0,0.823529,5,1.0,0.823529,2,0,2,2,37,2,0,0,0,12,0-p06.pddl
child-snack,prob-snack,2,7,38,14,0,54,8,6,0,0,41,1191,316,1507,2725,0,1600,0,42,0,112,26,72,968,6994,42,8,640,6256,0.065625,9.775,148.952,0.190476,25,15.2381,9.86531,19,15.2381,4.16224,272,148.952,116.612,230,148.952,79.9086,0,0,0,48,8.38095,17.5404,0,0,0,48,8.38095,17.5404,112,2040,6424,0.317559,0.054902,1,54,16.0286,0.150629,54,15.8381,0.0,198,47.8,0.150629,198,47.6095,0.0,1, /home/tomas/GitRepos/Gitforks/hapori/benchmarks/childsnack-strips/0-p07.pddl,72,976,3,13,4.333333,-7,-0.013889,1.006825,1,1.0,0.0,0.540984,0.069672,13,38,1,38,38,14,8,11,13,3,19,16,0.842105,11,8,0,0.842105,4,0.0,0.842105,2,0,2,2,42,2,0,0,0,13,0-p07.pddl
child-snack,prob-snack,2,7,42,14,0,61,9,6,0,0,41,1621,352,1973,3745,0,2340,0,47,0,125,29,80,1374,9972,47,9,810,9099,0.0580247,11.2333,193.596,0.191489,28,17.234,11.1302,21,17.234,4.39639,351,193.596,152.717,294,193.596,103.15,0,0,0,54,9.57447,19.9443,0,0,0,54,9.57447,19.9443,125,2886,9123,0.316343,0.0433125,1,71,21.4404,0.0,71,21.0574,0.0,266,68.834,0.0,266,68.4511,0.0,1, /home/tomas/GitRepos/Gitforks/hapori/benchmarks/childsnack-strips/0-p08.pddl,80,1382,3,14,4.666667,-8,-0.0125,1.054677,1,1.0,0.0,0.442836,0.052098,14,43,1,43,43,15,9,12,14,3,21,18,0.857143,12,9,0,0.857143,4,0.0,0.857143,2,0,2,2,47,2,0,0,0,14,0-p08.pddl
child-snack,prob-snack,2,7,46,14,0,68,10,6,0,0,41,2155,388,2543,5019,0,3280,0,52,0,138,32,88,1884,13720,52,10,1000,12700,0.052,12.7,244.231,0.192308,31,19.2308,12.3951,23,19.2308,4.61859,440,244.231,193.736,366,244.231,129.501,0,0,0,60,10.7692,22.3474,0,0,0,60,10.7692,22.3474,138,3944,12524,0.314915,0.0349899,1,90,27.3462,0.0,90,27.1538,0.0,342,92.4231,0.0,342,92.2308,0.0,1, /home/tomas/GitRepos/Gitforks/hapori/benchmarks/childsnack-strips/0-p09.pddl,88,1892,3,15,5.0,-9,-0.011364,1.102624,1,1.0,0.0,0.372093,0.040169,15,48,1,48,48,16,10,13,15,3,23,20,0.869565,13,10,0,0.869565,5,0.0,0.869565,2,0,2,2,52,2,0,0,0,15,0-p09.pddl
child-snack,prob-snack,2,7,50,14,0,73,11,6,0,0,41,2616,422,3038,6012,0,4070,0,57,0,151,35,96,2323,16810,57,11,1177,15422,0.0484282,13.1028,270.561,0.192982,34,20.6491,13.6362,25,20.6491,5.15204,506,270.561,217.721,418,270.561,149.245,0,0,0,66,11.5789,24.0664,0,0,0,66,11.5789,24.0664,151,5051,15919,0.317294,0.0298951,1,111,32.2947,0.0,111,32.1982,0.0650647,426,112.189,0.0,426,112.093,0.0650647,1, /home/tomas/GitRepos/Gitforks/hapori/benchmarks/childsnack-strips/0-p10.pddl,96,2331,3,16,5.333333,-10,-0.010417,1.150134,1,1.0,0.0,0.344916,0.03432,16,52,1,52,52,17,11,14,16,3,25,22,0.88,14,11,0,0.88,4,0.0,0.88,2,0,2,2,57,2,0,0,0,16,0-p10.pddl
child-snack,prob-snack,2,7,54,14,0,80,12,6,0,0,41,3353,458,3811,7761,0,5400,0,62,0,164,38,104,3036,22038,62,12,1404,20436,0.0441595,14.5556,329.613,0.193548,37,22.6452,14.903,27,22.6452,5.36144,612,329.613,266.257,504,329.613,180.705,0,0,0,72,12.7742,26.473,0,0,0,72,12.7742,26.473,164,6564,20736,0.316551,0.0249848,1,134,39.3677,0.0,134,39.3677,0.0,518,140.458,0.0,518,140.458,0.0,1, /home/tomas/GitRepos/Gitforks/hapori/benchmarks/childsnack-strips/0-p11.pddl,104,3044,3,17,5.666667,-11,-0.009615,1.196913,1,1.0,0.0,0.299606,0.027595,17,57,1,57,57,18,12,15,17,3,27,24,0.888889,15,12,0,0.888889,6,1.0,0.888889,2,0,2,2,62,2,0,0,0,17,0-p11.pddl
child-snack,prob-snack,2,7,62,14,0,94,14,6,0,0,41,5247,530,5777,12285,0,8876,0,72,0,190,44,120,4882,35608,72,14,1918,33530,0.0375391,17.4818,465.694,0.194444,43,26.6389,17.4358,31,26.6389,5.75738,854,465.694,378.084,700,465.694,252.965,0,0,0,84,15.1667,31.2832,0,0,0,84,15.1667,31.2832,190,10454,33232,0.314576,0.0181749,1,186,55.9472,0.232429,186,55.9472,0.232429,726,206.739,0.929714,726,206.739,0.232429,1, /home/tomas/GitRepos/Gitforks/hapori/benchmarks/childsnack-strips/0-p12.pddl,120,4890,3,19,6.333333,-13,-0.008333,1.287736,1,1.0,0.0,0.235583,0.018814,19,67,1,67,67,20,14,17,19,3,31,28,0.903226,17,14,0,0.903226,8,1.41421,0.903226,2,0,2,2,72,2,0,0,0,19,0-p12.pddl
child-snack,prob-snack,2,7,66,14,0,101,15,6,0,0,41,6428,566,6994,15120,0,11070,0,77,0,203,47,128,6039,44130,77,15,2205,41790,0.0349206,18.9524,542.727,0.194805,46,28.6364,18.702,33,28.6364,5.94544,990,542.727,441.367,810,542.727,293.76,0,0,0,90,16.3636,33.6872,0,0,0,90,16.3636,33.6872,203,12879,40989,0.314206,0.0157621,1,215,65.2597,0.337442,215,65.2597,0.337442,842,243.974,1.34977,842,243.974,0.337442,1, /home/tomas/GitRepos/Gitforks/hapori/benchmarks/childsnack-strips/0-p13.pddl,128,6047,3,20,6.666667,-14,-0.007812,1.331682,1,1.0,0.0,0.212337,0.015876,20,72,1,72,72,21,15,18,20,3,33,30,0.909091,18,15,0,0.909091,7,1.0,0.909091,2,0,2,2,77,2,0,0,0,20,0-p13.pddl
child-snack,prob-snack,2,7,23,14,0,29,4,6,0,0,41,340,232,572,783,0,200,0,23,0,68,15,48,196,1311,23,4,180,936,0.127778,5.2,40.6957,0.173913,13,7.82609,4.73334,12,7.82609,3.53433,71,40.6957,27.226,74,40.6957,22.8957,0,0,0,36,5.73913,12.6945,0,0,0,36,5.73913,12.6945,68,336,984,0.341463,0.202381,1,6,3.81159,0.0,6,3.28986,0.0,6,3.81159,0.0,6,3.28986,0.0,1, /home/tomas/GitRepos/Gitforks/hapori/benchmarks/childsnack-strips/0-p14.pddl,48,208,3,7,2.333333,-3,-0.020833,0.628808,1,1.0,0.0,1.774038,0.0,3,19,1,19,19,8,4,6,7,3,10,11,1.1,6,4,0,1.1,4,1.0,1.1,3,1,3,3,23,3,0,0,0,7,0-p14.pddl
child-snack,prob-snack,2,7,27,14,0,36,5,6,0,0,41,500,279,779,1163,0,410,0,28,0,82,18,57,331,2290,28,5,275,1830,0.101818,6.65455,65.3571,0.178571,16,9.82143,5.9884,14,9.82143,3.89187,113,65.3571,45.5115,112,65.3571,34.5566,0,0,0,45,7.5,16.2843,0,0,0,45,7.5,16.2843,82,626,1916,0.326722,0.13099,1,10,5.44048,0.273349,10,5.08333,0.0911164,13,5.52976,0.273349,13,5.17262,0.0911164,1, /home/tomas/GitRepos/Gitforks/hapori/benchmarks/childsnack-strips/0-p15.pddl,57,343,3,10,3.333333,-4,-0.017544,0.805491,1,1.0,0.0,1.41691,0.244898,10,24,1,24,24,11,5,8,10,3,13,10,0.769231,8,5,0,0.769231,2,0.0,0.769231,2,0,3,3,28,3,0,0,0,10,0-p15.pddl
child-snack,prob-snack,2,7,31,14,0,41,6,6,0,0,41,666,324,990,1527,0,624,0,33,0,96,21,66,474,3273,33,6,372,2646,0.0887097,7.1129,80.1818,0.181818,19,11.2727,7.22484,16,11.2727,4.32941,144,80.1818,57.849,137,80.1818,44.1996,0,0,0,54,8.72727,18.8636,0,0,0,54,8.72727,18.8636,96,942,2886,0.326403,0.101911,1,18,6.90909,0.0,18,6.36364,0.0,45,7.72727,0.0,45,7.18182,0.0,1, /home/tomas/GitRepos/Gitforks/hapori/benchmarks/childsnack-strips/0-p16.pddl,66,486,3,10,3.333333,-5,-0.015152,0.788024,1,1.0,0.0,1.092593,0.092593,8,28,1,28,28,11,6,8,10,3,14,12,0.857143,8,6,0,0.857143,4,0.0,0.857143,2,0,3,3,33,3,0,0,0,10,0-p16.pddl
child-snack,prob-snack,2,7,35,14,0,48,7,6,0,0,41,939,371,1310,2168,0,1036,0,38,0,110,24,75,722,5063,38,7,504,4305,0.0753968,8.54167,113.289,0.184211,22,13.2632,8.4874,18,13.2632,4.64353,203,113.289,83.6065,187,113.289,60.8008,0,0,0,63,10.5,22.4684,0,0,0,63,10.5,22.4684,110,1471,4579,0.321249,0.0747791,1,34,10.1228,0.0,34,9.9386,0.0,109,19.6096,0.0,109,19.4254,0.0,1, /home/tomas/GitRepos/Gitforks/hapori/benchmarks/childsnack-strips/0-p17.pddl,75,734,3,12,4.0,-6,-0.013333,0.886842,1,1.0,0.0,0.923706,0.13079,12,33,1,33,33,13,7,10,12,3,17,14,0.823529,10,7,0,0.823529,3,0.0,0.823529,2,0,3,3,38,3,0,0,0,12,0-p17.pddl
child-snack,prob-snack,2,7,39,14,0,55,8,6,0,0,41,1294,418,1712,3007,0,1600,0,43,0,124,27,84,1052,7455,43,8,656,6552,0.0655488,9.9878,152.372,0.186047,25,15.2558,9.75059,20,15.2558,4.93725,272,152.372,114.288,245,152.372,80.4826,0,0,0,72,12.2791,26.0717,0,0,0,72,12.2791,26.0717,124,2148,6756,0.31794,0.0577281,1,49,13.9147,0.0,49,13.9147,0.0,169,33.2636,0.0,169,33.2636,0.0,1, /home/tomas/GitRepos/Gitforks/hapori/benchmarks/childsnack-strips/0-p18.pddl,84,1064,3,13,4.333333,-7,-0.011905,0.932151,1,1.0,0.0,0.744361,0.095865,13,38,1,38,38,14,8,11,13,3,19,16,0.842105,11,8,0,0.842105,6,1.0,0.842105,2,0,3,3,43,3,0,0,0,13,0-p18.pddl
child-snack,prob-snack,2,7,43,14,0,62,9,6,0,0,41,1743,465,2208,4074,0,2340,0,48,0,138,30,93,1476,10539,48,9,828,9477,0.057971,11.4457,197.438,0.1875,28,17.25,11.0142,22,17.25,5.21416,351,197.438,149.885,311,197.438,103.26,0,0,0,81,14.0625,29.6742,0,0,0,81,14.0625,29.6742,138,3015,9522,0.316635,0.0457711,1,66,19.2188,0.211996,66,19.0312,0.0706653,237,53.5312,0.211996,237,53.3438,0.0706653,1, /home/tomas/GitRepos/Gitforks/hapori/benchmarks/childsnack-strips/0-p19.pddl,93,1488,3,14,4.666667,-8,-0.010753,0.978199,1,1.0,0.0,0.616935,0.072581,14,43,1,43,43,15,9,12,14,3,21,18,0.857143,12,9,0,0.857143,4,0.0,0.857143,2,0,3,3,48,3,0,0,0,14,0-p19.pddl
child-snack,prob-snack,2,7,47,14,0,69,10,6,0,0,41,2298,512,2810,5399,0,3280,0,53,0,152,33,102,2006,14405,53,10,1020,13170,0.0519608,12.9118,248.491,0.188679,31,19.2453,12.2781,24,19.2453,5.4769,440,248.491,190.39,385,248.491,129.139,0,0,0,90,15.8491,33.2761,0,0,0,90,15.8491,33.2761,152,4096,13036,0.314207,0.0371094,1,85,25.2013,0.0,85,24.8239,0.0,313,76.522,0.0,313,76.1447,0.0,1, /home/tomas/GitRepos/Gitforks/hapori/benchmarks/childsnack-strips/0-p20.pddl,102,2018,3,15,5.0,-9,-0.009804,1.02417,1,1.0,0.0,0.52329,0.056492,15,48,1,48,48,16,10,13,15,3,23,20,0.869565,13,10,0,0.869565,4,0.0,0.869565,2,0,3,3,53,3,0,0,0,15,0-p20.pddl
child-snack,prob-snack,2,7,51,14,0,74,11,6,0,0,41,2782,557,3339,6447,0,4070,0,58,0,166,36,111,2467,17614,58,11,1199,15972,0.0483736,13.3211,275.379,0.189655,34,20.6724,13.5193,26,20.6724,5.96654,506,275.379,214.394,430,275.379,148.527,0,0,0,99,17.069,35.8584,0,0,0,99,17.069,35.8584,166,5228,16481,0.317214,0.0317521,1,106,29.9626,0.0,106,29.773,0.0,397,95.4885,0.0,397,95.2989,0.0,1, /home/tomas/GitRepos/Gitforks/hapori/benchmarks/childsnack-strips/0-p21.pddl,111,2479,3,16,5.333333,-10,-0.009009,1.069609,1,1.0,0.0,0.486486,0.048407,16,52,1,52,52,17,11,14,16,3,25,22,0.88,14,11,0,0.88,5,0.0,0.88,2,0,3,3,58,3,0,0,0,16,0-p21.pddl
child-snack,prob-snack,2,7,55,14,0,81,12,6,0,0,41,3544,604,4148,8255,0,5400,0,63,0,180,39,120,3204,22983,63,12,1428,21096,0.0441176,14.7731,334.857,0.190476,37,22.6667,14.7852,28,22.6667,6.21315,612,334.857,262.412,516,334.857,179.505,0,0,0,108,18.8571,39.4658,0,0,0,108,18.8571,39.4658,180,6768,21420,0.315966,0.0265957,1,129,36.8095,0.0,129,36.8095,0.0,489,122.81,0.0,489,122.81,0.0,1, /home/tomas/GitRepos/Gitforks/hapori/benchmarks/childsnack-strips/0-p22.pddl,120,3216,3,17,5.666667,-11,-0.008333,1.11427,1,1.0,0.0,0.425373,0.039179,17,57,1,57,57,18,12,15,17,3,27,24,0.888889,15,12,0,0.888889,6,1.0,0.888889,2,0,3,3,63,3,0,0,0,17,0-p22.pddl
child-snack,prob-snack,2,7,63,14,0,95,14,6,0,0,41,5494,698,6192,12909,0,8876,0,73,0,208,45,138,5104,36871,73,14,1946,34440,0.0375128,17.6978,471.781,0.191781,43,26.6575,17.3167,32,26.6575,6.67898,854,471.781,373.198,712,471.781,250.797,0,0,0,126,22.4384,46.6773,0,0,0,126,22.4384,46.6773,208,10718,34112,0.3142,0.0194066,1,181,53.0868,0.346314,181,53.0868,0.346314,697,187.813,1.38525,697,187.813,0.346314,1, /home/tomas/GitRepos/Gitforks/hapori/benchmarks/childsnack-strips/0-p23.pddl,138,5116,3,19,6.333333,-13,-0.007246,1.200823,1,1.0,0.0,0.337764,0.026974,19,67,1,67,67,20,14,17,19,3,31,28,0.903226,17,14,0,0.903226,6,1.0,0.903226,2,0,3,3,73,3,0,0,0,19,0-p23.pddl
child-snack,prob-snack,2,7,67,14,0,102,15,6,0,0,41,6706,745,7451,15815,0,11070,0,78,0,222,48,147,6291,45570,78,15,2235,42840,0.0348993,19.1678,549.231,0.192308,46,28.6538,18.5823,34,28.6538,6.90007,990,549.231,435.959,822,549.231,291.107,0,0,0,135,24.2308,50.2818,0,0,0,135,24.2308,50.2818,222,13176,42021,0.313558,0.0168488,1,210,62.2308,0.502992,210,62.2308,0.502992,813,224.346,2.01197,813,224.346,0.502992,1, /home/tomas/GitRepos/Gitforks/hapori/benchmarks/childsnack-strips/0-p24.pddl,147,6303,3,20,6.666667,-14,-0.006803,1.242647,1,1.0,0.0,0.305569,0.022846,20,72,1,72,72,21,15,18,20,3,33,30,0.909091,18,15,0,0.909091,6,1.0,0.909091,2,0,3,3,78,3,0,0,0,20,0-p24.pddl
child-snack,prob-snack,2,7,71,14,0,107,16,6,0,0,41,7690,790,8480,17943,0,12800,0,83,0,236,51,156,7252,52311,83,16,2496,48816,0.0332532,19.5577,588.145,0.192771,49,30.0723,19.8244,36,30.0723,7.43451,1088,588.145,471.609,896,588.145,320.276,0,0,0,144,25.4458,52.8643,0,0,0,144,25.4458,52.8643,236,15588,49380,0.315674,0.0151399,1,241,69.6345,0.650651,241,69.6345,0.650651,937,253.924,2.6026,937,253.924,0.650651,1, /home/tomas/GitRepos/Gitforks/hapori/benchmarks/childsnack-strips/0-p25.pddl,156,7264,3,21,7.0,-15,-0.00641,1.283509,1,1.0,0.0,0.294053,0.02065,21,76,1,76,76,22,16,19,21,3,35,32,0.914286,19,16,0,0.914286,6,1.0,0.914286,2,0,3,3,83,3,0,0,0,21,0-p25.pddl
child-snack,prob-snack,2,7,47,14,0,57,8,6,0,0,41,1944,708,2652,4347,0,2336,0,59,0,188,51,156,1636,11095,59,8,1016,8928,0.0580709,8.7874,151.322,0.135593,40,17.2203,12.9197,35,17.2203,8.62017,400,151.322,130.459,352,151.322,108.746,0,0,0,144,15.4576,39.9556,0,0,0,144,15.4576,39.9556,188,3828,11556,0.331256,0.0491118,1,101,21.3503,0.767894,101,21.0791,0.767894,377,66.6384,3.07158,377,66.3672,0.767894,1, /home/tomas/GitRepos/Gitforks/hapori/benchmarks/childsnack-strips/0-p26.pddl,132,1648,3,13,4.333333,-7,-0.007576,0.743621,1,1.0,0.0,0.830097,0.091019,13,35,1,35,35,14,8,11,13,3,19,16,0.842105,11,8,0,0.842105,3,0.0,0.842105,2,0,3,3,59,3,0,0,0,13,0-p26.pddl
child-snack,prob-snack,2,7,52,14,0,63,9,6,0,0,41,2536,790,3326,5588,0,3240,0,66,0,210,57,174,2196,14877,66,9,1251,12042,0.0527578,9.6259,182.455,0.136364,45,18.9545,14.4458,39,18.9545,9.70228,486,182.455,159.369,432,182.455,135.259,0,0,0,162,17.1818,44.2499,0,0,0,162,17.1818,44.2499,210,5274,15858,0.332577,0.039818,1,135,27.2727,1.09104,135,27.0,1.09104,513,90.2727,4.36415,513,90.0,1.09104,1, /home/tomas/GitRepos/Gitforks/hapori/benchmarks/childsnack-strips/0-p27.pddl,147,2208,3,14,4.666667,-8,-0.006803,0.778072,1,1.0,0.0,0.733696,0.07337,14,39,1,39,39,15,9,12,14,3,21,18,0.857143,12,9,0,0.857143,4,0.0,0.857143,2,0,3,3,66,3,0,0,0,14,0-p27.pddl
child-snack,prob-snack,2,7,57,14,0,71,10,6,0,0,41,3390,874,4264,7493,0,4640,0,73,0,232,63,192,3016,20655,73,10,1570,17220,0.0464968,10.9682,235.89,0.136986,50,21.5068,16.3247,43,21.5068,10.4319,640,235.89,210.061,560,235.89,172.151,0,0,0,180,19.726,50.6931,0,0,0,180,19.726,50.6931,232,7196,21836,0.329548,0.0322401,1,173,34.4155,1.38525,173,34.1416,1.38525,665,117.155,5.54102,665,116.881,1.38525,1, /home/tomas/GitRepos/Gitforks/hapori/benchmarks/childsnack-strips/0-p28.pddl,162,3028,3,15,5.0,-9,-0.006173,0.812684,1,1.0,0.0,0.626156,0.057464,15,44,1,44,44,16,10,13,15,3,23,20,0.869565,13,10,0,0.869565,4,0.0,0.869565,2,0,3,3,73,3,0,0,0,15,0-p28.pddl
child-snack,prob-snack,2,7,62,14,0,77,11,6,0,0,41,4248,956,5204,9280,0,6028,0,80,0,254,69,210,3842,26271,80,11,1859,21912,0.0430339,11.787,273.9,0.1375,55,23.2375,17.8523,47,23.2375,11.5242,748,273.9,245.712,660,273.9,205.341,0,0,0,198,21.45,54.9972,0,0,0,198,21.45,54.9972,254,9364,28372,0.330044,0.0271252,1,215,41.6833,1.65609,215,41.4083,1.65609,833,146.183,6.62435,833,145.908,1.65609,1, /home/tomas/GitRepos/Gitforks/hapori/benchmarks/childsnack-strips/0-p29.pddl,177,3854,3,16,5.333333,-10,-0.00565,0.847043,1,1.0,0.0,0.569798,0.048262,16,48,1,48,48,17,11,14,16,3,25,22,0.88,14,11,0,0.88,4,0.0,0.88,2,0,3,3,80,3,0,0,0,16,0-p29.pddl
child-snack,prob-snack,2,7,67,14,0,83,12,6,0,0,41,5250,1038,6288,11355,0,7680,0,87,0,276,75,228,4812,32871,87,12,2172,27432,0.0400552,12.6298,315.31,0.137931,60,24.9655,19.3738,51,24.9655,12.6286,864,315.31,284.581,768,315.31,241.847,0,0,0,216,23.1724,59.2866,0,0,0,216,23.1724,59.2866,276,11940,36132,0.330455,0.0231156,1,261,49.6207,1.90762,261,49.3448,1.90762,1017,177.897,7.63048,1017,177.621,1.90762,1, /home/tomas/GitRepos/Gitforks/hapori/benchmarks/childsnack-strips/0-p30.pddl,192,4824,3,17,5.666667,-11,-0.005208,0.880917,1,1.0,0.0,0.522388,0.041045,17,52,1,52,52,18,12,15,17,3,27,24,0.888889,15,12,0,0.888889,5,1.0,0.888889,2,0,3,3,87,3,0,0,0,17,0-p30.pddl
child-snack,prob-snack,2,7,28,14,0,37,5,6,0,0,41,558,348,906,1328,0,410,0,29,0,91,19,66,373,2510,29,5,285,1950,0.101754,6.84211,67.2414,0.172414,16,9.82759,5.88434,15,9.82759,4.52631,118,67.2414,44.5357,122,67.2414,37.4255,0,0,0,60,9.65517,21.4127,0,0,0,60,9.65517,21.4127,91,683,2073,0.329474,0.133236,1,12,5.56158,0.0,11,5.21675,0.0,12,5.56158,0.0,11,5.21675,0.0,1, /home/tomas/GitRepos/Gitforks/hapori/benchmarks/childsnack-strips/1-p01.pddl,66,389,3,10,3.333333,-4,-0.015152,0.748583,1,1.0,0.0,1.66581,0.287918,10,24,1,24,24,11,5,8,10,3,13,10,0.769231,8,5,0,0.769231,2,0.0,0.769231,2,0,4,4,29,4,0,0,0,10,1-p01.pddl
child-snack,prob-snack,2,7,32,14,0,42,6,6,0,0,41,737,404,1141,1727,0,624,0,34,0,106,22,76,528,3558,34,6,384,2808,0.0885417,7.3125,82.5882,0.176471,19,11.2941,7.11886,17,11.2941,4.95586,144,82.5882,56.7793,148,82.5882,46.8478,0,0,0,72,11.2941,24.8567,0,0,0,72,11.2941,24.8567,106,1032,3120,0.330769,0.102713,1,16,6.78151,0.0,16,6.60504,0.0,28,7.08403,0.0,28,6.90756,0.0,1, /home/tomas/GitRepos/Gitforks/hapori/benchmarks/childsnack-strips/1-p02.pddl,76,544,3,11,3.666667,-5,-0.013158,0.786287,1,1.0,0.0,1.411765,0.220588,11,28,1,28,28,12,6,9,11,3,15,12,0.8,9,6,0,0.8,3,0.0,0.8,2,0,4,4,34,4,0,0,0,11,1-p02.pddl
child-snack,prob-snack,2,7,36,14,0,49,7,6,0,0,41,1025,462,1487,2407,0,1036,0,39,0,121,25,86,790,5430,39,7,518,4529,0.0752896,8.74324,116.128,0.179487,22,13.2821,8.37869,19,13.2821,5.3106,203,116.128,82.0676,200,116.128,63.1722,0,0,0,84,13.641,29.654,0,0,0,84,13.641,29.654,121,1532,4731,0.323822,0.0789817,1,25,8.96154,0.156022,25,8.78205,0.0,64,10.5,0.156022,64,10.3205,0.0,1, /home/tomas/GitRepos/Gitforks/hapori/benchmarks/childsnack-strips/1-p03.pddl,86,806,3,11,3.666667,-6,-0.011628,0.784948,1,1.0,0.0,1.042184,0.079404,9,33,1,33,33,12,7,9,11,3,16,14,0.875,9,7,0,0.875,5,1.0,0.875,2,0,4,4,39,4,0,0,0,11,1-p03.pddl
child-snack,prob-snack,2,7,44,14,0,63,9,6,0,0,41,1865,578,2443,4403,0,2340,0,49,0,151,31,106,1578,11106,49,9,846,9855,0.0579196,11.6489,201.122,0.183673,28,17.2653,10.9017,23,17.2653,5.95485,351,201.122,147.367,328,201.122,104.87,0,0,0,108,18.3673,39.2494,0,0,0,108,18.3673,39.2494,151,3108,9849,0.315565,0.0485843,1,57,17.1035,0.0,57,17.1035,0.0,192,39.105,0.0,192,39.105,0.0,1, /home/tomas/GitRepos/Gitforks/hapori/benchmarks/childsnack-strips/1-p04.pddl,106,1594,3,13,4.333333,-8,-0.009434,0.884833,1,1.0,0.0,0.72271,0.045169,11,43,1,43,43,14,9,11,13,3,20,18,0.9,11,9,0,0.9,5,1.0,0.9,2,0,4,4,49,4,0,0,0,13,1-p04.pddl
child-snack,prob-snack,2,7,48,14,0,70,10,6,0,0,41,2441,636,3077,5779,0,3280,0,54,0,166,34,116,2128,15090,54,10,1040,13640,0.0519231,13.1154,252.593,0.185185,31,19.2593,12.1643,25,19.2593,6.25147,440,252.593,187.372,404,252.593,130.316,0,0,0,120,20.7407,44.0476,0,0,0,120,20.7407,44.0476,166,4248,13488,0.314947,0.0390772,1,80,23.1058,0.133563,80,22.9206,0.0,284,61.836,0.133563,284,61.6508,0.0,1, /home/tomas/GitRepos/Gitforks/hapori/benchmarks/childsnack-strips/1-p05.pddl,116,2144,3,15,5.0,-9,-0.008621,0.960385,1,1.0,0.0,0.656716,0.070896,15,48,1,48,48,16,10,13,15,3,23,20,0.869565,13,10,0,0.869565,5,0.0,0.869565,2,0,4,4,54,4,0,0,0,15,1-p05.pddl
child-snack,prob-snack,2,7,56,14,0,82,12,6,0,0,41,3735,750,4485,8749,0,5400,0,64,0,196,40,136,3372,23928,64,12,1452,21756,0.0440771,14.9835,339.938,0.1875,37,22.6875,14.6702,29,22.6875,6.99302,612,339.938,258.87,538,339.938,179.864,0,0,0,144,24.75,52.3014,0,0,0,144,24.75,52.3014,196,6972,22080,0.315761,0.0281124,1,124,34.567,0.0,124,34.567,0.0,460,106.848,0.0,460,106.848,0.0,1, /home/tomas/GitRepos/Gitforks/hapori/benchmarks/childsnack-strips/1-p06.pddl,136,3388,3,17,5.666667,-11,-0.007353,1.046678,1,1.0,0.0,0.538371,0.049587,17,57,1,57,57,18,12,15,17,3,27,24,0.888889,15,12,0,0.888889,6,1.0,0.888889,2,0,4,4,64,4,0,0,0,17,1-p06.pddl
child-snack,prob-snack,2,7,60,14,0,89,13,6,0,0,41,4662,808,5470,10956,0,6994,0,69,0,211,43,146,4273,30470,69,13,1703,28002,0.0405167,16.4427,405.826,0.188406,40,24.6812,15.9351,31,24.6812,7.26016,728,405.826,311.297,634,405.826,213.489,0,0,0,156,27.1304,57.1065,0,0,0,156,27.1304,57.1065,211,8823,28037,0.314691,0.0239148,1,149,42.2692,0.237282,149,42.2692,0.237282,560,137.549,0.949129,560,137.549,0.237282,1, /home/tomas/GitRepos/Gitforks/hapori/benchmarks/childsnack-strips/1-p07.pddl,146,4289,3,18,6.0,-12,-0.006849,1.088524,1,1.0,0.0,0.479366,0.041035,18,62,1,62,62,19,13,16,18,3,29,26,0.896552,16,13,0,0.896552,5,1.0,0.896552,2,0,4,4,69,4,0,0,0,18,1-p07.pddl
child-snack,prob-snack,2,7,64,14,0,96,14,6,0,0,41,5741,866,6607,13533,0,8876,0,74,0,226,46,156,5326,38134,74,14,1974,35350,0.0374873,17.9078,477.703,0.189189,43,26.6757,17.2,33,26.6757,7.51774,854,477.703,368.635,738,477.703,250.218,0,0,0,168,29.5135,61.9108,0,0,0,168,29.5135,61.9108,226,10982,35048,0.313342,0.0205791,1,176,50.6351,0.458707,176,50.6351,0.458707,668,170.919,1.83483,668,170.919,0.458707,1, /home/tomas/GitRepos/Gitforks/hapori/benchmarks/childsnack-strips/1-p08.pddl,156,5342,3,19,6.333333,-13,-0.00641,1.129425,1,1.0,0.0,0.431299,0.034444,19,67,1,67,67,20,14,17,19,3,31,28,0.903226,17,14,0,0.903226,7,1.0,0.903226,2,0,4,4,74,4,0,0,0,19,1-p08.pddl
child-snack,prob-snack,2,7,72,14,0,108,16,6,0,0,41,8001,980,8981,18713,0,12800,0,84,0,256,52,176,7536,53924,84,16,2528,49984,0.0332278,19.7722,595.048,0.190476,49,30.0952,19.7072,37,30.0952,8.26873,1088,595.048,466.545,916,595.048,318.864,0,0,0,192,33.5238,70.1615,0,0,0,192,33.5238,70.1615,256,15920,50480,0.315372,0.0160804,1,236,66.9728,0.86248,236,66.9728,0.86248,908,236.116,3.44992,908,236.116,0.86248,1, /home/tomas/GitRepos/Gitforks/hapori/benchmarks/childsnack-strips/1-p09.pddl,176,7552,3,21,7.0,-15,-0.005682,1.208385,1,1.0,0.0,0.377119,0.026483,21,76,1,76,76,22,16,19,21,3,35,32,0.914286,19,16,0,0.914286,9,1.41421,0.914286,2,0,4,4,84,4,0,0,0,21,1-p09.pddl
child-snack,prob-snack,2,7,76,14,0,115,17,6,0,0,41,9549,1038,10587,22403,0,15572,0,89,0,271,55,186,9058,65018,89,17,2856,60639,0.0311625,21.2321,681.337,0.191011,52,32.0899,20.9733,39,32.0899,8.50729,1241,681.337,536.312,1040,681.337,363.805,0,0,0,204,35.9101,74.9699,0,0,0,204,35.9101,74.9699,271,19088,60721,0.314356,0.0141974,1,269,77.126,1.04809,269,77.126,1.04809,1040,276.665,4.19235,1040,276.665,1.04809,1, /home/tomas/GitRepos/Gitforks/hapori/benchmarks/childsnack-strips/1-p10.pddl,186,9074,3,22,7.333333,-16,-0.005376,1.246489,1,1.0,0.0,0.346484,0.022923,22,81,1,81,81,23,17,20,22,3,37,34,0.918919,20,17,0,0.918919,6,1.0,0.918919,2,0,4,4,89,4,0,0,0,22,1-p10.pddl
child-snack,prob-snack,2,7,84,14,0,129,19,6,0,0,41,13245,1154,14399,31247,0,22268,0,99,0,301,61,206,12702,91646,99,19,3572,86317,0.0277156,24.1649,871.889,0.191919,58,36.0808,23.5053,43,36.0808,8.96534,1577,871.889,690.587,1312,871.889,463.015,0,0,0,228,40.6869,84.5839,0,0,0,228,40.6869,84.5839,301,26648,85035,0.313377,0.0112954,1,341,99.412,1.39284,341,99.412,1.39284,1328,365.7,5.57136,1328,365.7,1.39284,1, /home/tomas/GitRepos/Gitforks/hapori/benchmarks/childsnack-strips/1-p11.pddl,206,12718,3,24,8.0,-18,-0.004854,1.320112,1,1.0,0.0,0.297531,0.017613,24,91,1,91,91,25,19,22,24,3,41,38,0.926829,22,19,0,0.926829,12,1.73205,0.926829,2,0,4,4,99,4,0,0,0,24,1-p11.pddl
child-snack,prob-snack,2,7,88,14,0,136,20,6,0,0,41,15417,1212,16629,36461,0,26240,0,104,0,316,64,216,14848,107360,104,20,3960,101520,0.0262626,25.6364,976.154,0.192308,61,38.0769,24.7711,45,38.0769,9.18579,1760,976.154,775.089,1460,976.154,517.283,0,0,0,240,43.0769,89.3898,0,0,0,240,43.0769,89.3898,316,31088,99248,0.313236,0.0101647,1,380,111.544,1.55384,380,111.544,1.55384,1484,414.181,6.21537,1484,414.181,1.55384,1, /home/tomas/GitRepos/Gitforks/hapori/benchmarks/childsnack-strips/1-p12.pddl,216,14864,3,25,8.333333,-19,-0.00463,1.355707,1,1.0,0.0,0.277718,0.015608,25,96,1,96,96,26,20,23,25,3,43,40,0.930233,23,20,0,0.930233,12,1.73205,0.930233,2,0,4,4,104,4,0,0,0,25,1-p12.pddl
child-snack,prob-snack,2,7,92,14,0,141,21,6,0,0,41,17126,1268,18394,40160,0,29274,0,109,0,331,67,226,16533,119166,109,21,4305,112014,0.0253194,26.0195,1027.65,0.192661,64,39.4954,26.0136,47,39.4954,9.72052,1890,1027.65,822.408,1554,1027.65,555.879,0,0,0,252,44.6972,92.836,0,0,0,252,44.6972,92.836,331,35307,112209,0.314654,0.00937491,1,421,121.156,1.70827,421,121.156,1.70827,1648,452.587,6.83308,1648,452.587,1.70827,1, /home/tomas/GitRepos/Gitforks/hapori/benchmarks/childsnack-strips/1-p13.pddl,226,16549,3,26,8.666667,-20,-0.004425,1.390543,1,1.0,0.0,0.271195,0.014502,26,100,1,100,100,27,21,24,26,3,45,42,0.933333,24,21,0,0.933333,7,1.41421,0.933333,2,0,4,4,109,4,0,0,0,26,1-p13.pddl
child-snack,prob-snack,2,7,100,14,0,155,23,6,0,0,41,22520,1384,23904,53074,0,39238,0,119,0,361,73,246,21875,158282,119,23,5175,149822,0.0229952,28.9511,1259.01,0.193277,70,43.4874,28.5468,51,43.4874,10.1434,2300,1259.01,1011.38,1886,1259.01,677.749,0,0,0,276,49.479,102.454,0,0,0,276,49.479,102.454,361,46485,148099,0.313878,0.00776595,1,509,148.317,1.99979,509,148.317,1.99979,2000,561.157,7.99916,2000,561.157,1.99979,1, /home/tomas/GitRepos/Gitforks/hapori/benchmarks/childsnack-strips/1-p14.pddl,246,21891,3,28,9.333333,-22,-0.004065,1.458081,1,1.0,0.0,0.240099,0.011694,28,110,1,110,110,29,23,26,28,3,49,46,0.938776,26,23,0,0.938776,13,1.73205,0.938776,2,0,4,4,119,4,0,0,0,28,1-p14.pddl
child-snack,prob-snack,2,7,104,14,0,162,24,6,0,0,41,25607,1442,27049,60485,0,44976,0,124,0,376,76,256,24936,180732,124,24,5640,171576,0.0219858,30.4213,1383.68,0.193548,73,45.4839,29.8133,53,45.4839,10.3484,2520,1383.68,1113.24,2064,1383.68,743.349,0,0,0,288,51.871,107.261,0,0,0,288,51.871,107.261,376,52872,168624,0.31355,0.00711151,1,556,162.885,2.13788,556,162.885,2.13788,2188,619.396,8.55153,2188,619.396,2.13788,1, /home/tomas/GitRepos/Gitforks/hapori/benchmarks/childsnack-strips/1-p15.pddl,256,24952,3,29,9.666667,-23,-0.003906,1.490852,1,1.0,0.0,0.226996,0.01058,29,115,1,115,115,30,24,27,29,3,51,48,0.941176,27,24,0,0.941176,9,1.73205,0.941176,2,0,4,4,124,4,0,0,0,29,1-p15.pddl
child-snack,prob-snack,2,7,108,14,0,169,25,6,0,0,41,28970,1500,30470,68572,0,51250,0,129,0,391,79,266,28273,205230,129,25,6125,195350,0.0210612,31.8939,1514.34,0.193798,76,47.4806,31.0796,55,47.4806,10.5493,2750,1514.34,1220.0,2250,1514.34,812.057,0,0,0,300,54.2636,112.068,0,0,0,300,54.2636,112.068,391,59823,191073,0.31309,0.00653595,1,605,178.111,2.27143,605,178.111,2.27143,2384,680.27,9.08571,2384,680.27,2.27143,1, /home/tomas/GitRepos/Gitforks/hapori/benchmarks/childsnack-strips/1-p16.pddl,266,28289,3,30,10.0,-24,-0.003759,1.523002,1,1.0,0.0,0.215207,0.009615,30,120,1,120,120,31,25,28,30,3,53,50,0.943396,28,25,0,0.943396,10,1.73205,0.943396,2,0,4,4,129,4,0,0,0,30,1-p16.pddl
child-snack,prob-snack,2,7,116,14,0,181,27,6,0,0,41,35409,1614,37023,83407,0,63180,0,139,0,421,85,286,34662,251334,139,27,7074,238653,0.0196494,33.7366,1716.93,0.194245,82,50.8921,33.5891,59,50.8921,11.3078,3159,1716.93,1393.26,2592,1716.93,934.252,0,0,0,324,58.2734,120.324,0,0,0,324,58.2734,120.324,421,74352,236703,0.314115,0.00566226,1,709,206.36,2.52626,709,206.36,2.52626,2800,793.215,10.105,2800,793.215,2.52626,1, /home/tomas/GitRepos/Gitforks/hapori/benchmarks/childsnack-strips/1-p17.pddl,286,34678,3,32,10.666667,-26,-0.003497,1.585552,1,1.0,0.0,0.201396,0.008305,32,129,1,129,129,33,27,30,32,3,57,54,0.947368,30,27,0,0.947368,10,1.73205,0.947368,2,0,4,4,139,4,0,0,0,32,1-p17.pddl
child-snack,prob-snack,2,7,120,14,0,188,28,6,0,0,41,39573,1672,41245,93405,0,71008,0,144,0,436,88,296,38800,281720,144,28,7616,268128,0.0189076,35.2059,1862.0,0.194444,85,52.8889,34.8559,61,52.8889,11.5007,3416,1862.0,1512.47,2800,1862.0,1011.18,0,0,0,336,60.6667,125.133,0,0,0,336,60.6667,125.133,436,83040,264592,0.313842,0.00525048,1,764,223.361,2.64815,764,223.361,2.64815,3020,861.194,10.5926,3020,861.194,2.64815,1, /home/tomas/GitRepos/Gitforks/hapori/benchmarks/childsnack-strips/1-p18.pddl,296,38816,3,33,11.0,-27,-0.003378,1.616006,1,1.0,0.0,0.192086,0.007626,33,134,1,134,134,34,28,31,33,3,59,56,0.949153,31,28,0,0.949153,12,1.73205,0.949153,2,0,4,4,144,4,0,0,0,33,1-p18.pddl
child-snack,prob-snack,2,7,128,14,0,202,30,6,0,0,41,48873,1788,50661,115783,0,88560,0,154,0,466,94,316,48048,349710,154,30,8760,334200,0.0175799,38.1507,2170.13,0.194805,91,56.8831,37.3891,65,56.8831,11.877,3960,2170.13,1765.61,3240,2170.13,1174.38,0,0,0,360,65.4545,134.749,0,0,0,360,65.4545,134.749,466,102408,326808,0.313358,0.00455043,1,880,259.336,2.88213,880,259.336,2.88213,3484,1005.05,11.5285,3484,1005.05,2.88213,1, /home/tomas/GitRepos/Gitforks/hapori/benchmarks/childsnack-strips/1-p19.pddl,316,48064,3,35,11.666667,-29,-0.003165,1.675396,1,1.0,0.0,0.175766,0.006491,35,144,1,144,144,36,30,33,35,3,63,60,0.952381,33,30,0,0.952381,14,2.0,0.952381,2,0,4,4,154,4,0,0,0,35,1-p19.pddl
child-snack,prob-snack,2,7,132,14,0,207,31,6,0,0,41,52512,1844,54356,123662,0,95294,0,159,0,481,97,326,51663,375218,159,31,9269,357058,0.017154,38.5217,2245.65,0.194969,94,58.2956,38.6317,67,58.2956,12.4625,4154,2245.65,1836.22,3410,2245.65,1232.52,0,0,0,372,67.0692,138.194,0,0,0,372,67.0692,138.194,481,111617,355091,0.314334,0.00430938,1,941,273.533,2.99464,941,273.533,2.99464,3728,1061.82,11.9786,3728,1061.82,2.99464,1, /home/tomas/GitRepos/Gitforks/hapori/benchmarks/childsnack-strips/1-p20.pddl,326,51679,3,36,12.0,-30,-0.003067,1.704376,1,1.0,0.0,0.173533,0.006192,36,148,1,148,148,37,31,34,36,3,65,62,0.953846,34,31,0,0.953846,11,2.0,0.953846,2,0,4,4,159,4,0,0,0,36,1-p20.pddl
child-snack,prob-snack,2,7,136,14,0,214,32,6,0,0,41,57915,1902,59817,136637,0,105536,0,164,0,496,100,336,57040,414740,164,32,9888,395424,0.0165858,39.9903,2411.12,0.195122,97,60.2927,39.8988,69,60.2927,12.6457,4448,2411.12,1972.78,3648,2411.12,1320.79,0,0,0,384,69.4634,143.004,0,0,0,384,69.4634,143.004,496,122960,391472,0.314097,0.00403383,1,1004,292.965,3.10443,1004,292.965,3.10443,3980,1139.53,12.4177,3980,1139.53,3.10443,1, /home/tomas/GitRepos/Gitforks/hapori/benchmarks/childsnack-strips/1-p21.pddl,336,57056,3,37,12.333333,-31,-0.002976,1.732907,1,1.0,0.0,0.166573,0.005749,37,153,1,153,153,38,32,35,37,3,67,64,0.955224,35,32,0,0.955224,12,2.0,0.955224,2,0,4,4,164,4,0,0,0,37,1-p21.pddl
child-snack,prob-snack,2,7,144,14,0,228,34,6,0,0,41,69825,2018,71843,165293,0,128180,0,174,0,526,106,356,68898,501986,174,34,11186,480250,0.0155552,42.9331,2760.06,0.195402,103,64.2874,42.4326,73,64.2874,13.0043,5066,2760.06,2260.64,4148,2760.06,1506.65,0,0,0,408,74.2529,152.622,0,0,0,408,74.2529,152.622,526,147914,471560,0.31367,0.00355612,1,1136,333.802,3.31646,1136,333.802,3.31646,4508,1302.84,13.2658,4508,1302.84,3.31646,1, /home/tomas/GitRepos/Gitforks/hapori/benchmarks/childsnack-strips/1-p22.pddl,356,68914,3,39,13.0,-33,-0.002809,1.788695,1,1.0,0.0,0.154163,0.004992,39,163,1,163,163,40,34,37,39,3,71,68,0.957746,37,34,0,0.957746,14,2.0,0.957746,2,0,4,4,174,4,0,0,0,39,1-p22.pddl
child-snack,prob-snack,2,7,106,14,0,146,20,6,0,0,41,24123,1256,25379,54425,0,43520,0,142,0,408,122,328,23464,168330,142,20,6440,154640,0.0220497,24.0124,1089.01,0.140845,100,45.3521,34.4302,82,45.3521,17.9382,3040,1089.01,1076.46,2560,1089.01,802.596,0,0,0,240,29.2958,73.8351,0,0,0,240,29.2958,73.8351,408,55704,173464,0.321127,0.00732443,1,782,157.394,2.33316,782,157.394,2.33316,3110,612.718,9.33264,3110,612.718,2.33316,1, /home/tomas/GitRepos/Gitforks/hapori/benchmarks/childsnack-strips/1-p23.pddl,268,23472,3,25,8.333333,-19,-0.003731,1.217099,1,1.0,0.0,0.169734,0.00835,25,92,1,92,92,26,20,23,25,3,43,40,0.930233,23,20,0,0.930233,11,1.41421,0.930233,2,0,2,2,142,2,0,0,0,25,1-p23.pddl
child-snack,prob-snack,2,7,111,14,0,152,21,6,0,0,41,27131,1316,28447,60750,0,49140,0,149,0,428,128,344,26442,189216,149,21,7014,172956,0.0212432,24.6587,1160.78,0.14094,105,47.0738,35.9842,86,47.0738,19.0369,3276,1160.78,1148.87,2772,1160.78,870.423,0,0,0,252,30.443,76.7623,0,0,0,252,30.443,76.7623,428,63738,197886,0.322095,0.00671499,1,864,171.648,2.4412,864,171.648,2.4412,3438,669.729,9.7648,3438,669.729,2.4412,1, /home/tomas/GitRepos/Gitforks/hapori/benchmarks/childsnack-strips/1-p24.pddl,281,26450,3,26,8.666667,-20,-0.003559,1.247056,1,1.0,0.0,0.164234,0.007713,26,96,1,96,96,27,21,24,26,3,45,42,0.933333,24,21,0,0.933333,10,1.41421,0.933333,2,0,2,2,149,2,0,0,0,26,1-p24.pddl
child-snack,prob-snack,2,7,116,14,0,160,22,6,0,0,41,31501,1378,32879,70899,0,57464,0,156,0,448,134,360,30780,220794,156,22,7744,202884,0.0201446,26.1989,1300.54,0.141026,110,49.641,37.8458,90,49.641,19.7516,3652,1300.54,1290.64,3080,1300.54,968.41,0,0,0,264,32.1538,81.0013,0,0,0,264,32.1538,81.0013,448,73636,229088,0.321431,0.00608398,1,950,190.113,2.54563,950,190.113,2.54563,3782,743.582,10.1825,3782,743.582,2.54563,1, /home/tomas/GitRepos/Gitforks/hapori/benchmarks/childsnack-strips/1-p25.pddl,294,30788,3,27,9.0,-21,-0.003401,1.276417,1,1.0,0.0,0.153306,0.006886,27,101,1,101,101,28,22,25,27,3,47,44,0.93617,25,22,0,0.93617,9,1.41421,0.93617,2,0,2,2,156,2,0,0,0,27,1-p25.pddl
child-snack,prob-snack,2,7,121,14,0,166,23,6,0,0,41,35091,1438,36529,78438,0,64216,0,163,0,468,140,376,34340,245776,163,23,8372,224802,0.0194697,26.8516,1379.15,0.141104,115,51.362,39.3977,94,51.362,20.8547,3910,1379.15,1369.83,3312,1379.15,1042.86,0,0,0,276,33.3006,83.9256,0,0,0,276,33.3006,83.9256,468,83284,258406,0.322299,0.00561933,1,1040,205.739,2.64675,1040,205.739,2.64675,4142,806.081,10.587,4142,806.081,2.64675,1, /home/tomas/GitRepos/Gitforks/hapori/benchmarks/childsnack-strips/1-p26.pddl,307,34348,3,28,9.333333,-22,-0.003257,1.30521,1,1.0,0.0,0.14883,0.006405,28,105,1,105,105,29,23,26,28,3,49,46,0.938776,26,23,0,0.938776,10,1.41421,0.938776,2,0,2,2,163,2,0,0,0,28,1-p26.pddl
child-snack,prob-snack,2,7,126,14,0,174,24,6,0,0,41,40263,1500,41763,90437,0,74112,0,170,0,488,146,392,39480,283194,170,24,9168,260256,0.0185428,28.3874,1530.92,0.141176,120,53.9294,41.2607,98,53.9294,21.5678,4320,1530.92,1524.22,3648,1530.92,1149.85,0,0,0,288,35.0118,88.1665,0,0,0,288,35.0118,88.1665,488,95064,295512,0.321693,0.00513338,1,1134,225.861,2.74483,1134,225.861,2.74483,4518,886.567,10.9793,4518,886.567,2.74483,1, /home/tomas/GitRepos/Gitforks/hapori/benchmarks/childsnack-strips/1-p27.pddl,320,39488,3,29,9.666667,-23,-0.003125,1.33346,1,1.0,0.0,0.139789,0.005774,29,110,1,110,110,30,24,27,29,3,51,48,0.941176,27,24,0,0.941176,11,1.73205,0.941176,2,0,2,2,170,2,0,0,0,29,1-p27.pddl
child-snack,prob-snack,2,7,131,14,0,182,25,6,0,0,41,45939,1562,47501,103652,0,85000,0,177,0,508,152,408,45124,324340,177,25,10000,299350,0.0177,29.935,1691.24,0.141243,125,56.4972,43.1217,102,56.4972,22.282,4750,1691.24,1687.14,4000,1691.24,1262.3,0,0,0,300,36.7232,92.4035,0,0,0,300,36.7232,92.4035,508,107924,336074,0.321132,0.00470702,1,1232,246.955,2.84012,1232,246.955,2.84012,4910,970.938,11.3605,4910,970.938,2.84012,1, /home/tomas/GitRepos/Gitforks/hapori/benchmarks/childsnack-strips/1-p28.pddl,333,45132,3,30,10.0,-24,-0.003003,1.361192,1,1.0,0.0,0.131703,0.005229,30,115,1,115,115,31,25,28,30,3,53,50,0.943396,28,25,0,0.943396,11,1.73205,0.943396,2,0,2,2,177,2,0,0,0,30,1-p28.pddl
child-snack,prob-snack,2,7,136,14,0,188,26,6,0,0,41,50529,1622,52151,113303,0,93704,0,184,0,528,158,424,49684,356394,184,26,10712,327548,0.017177,30.5777,1780.15,0.141304,130,58.2174,44.6749,106,58.2174,23.3861,5044,1780.15,1777.22,4264,1780.15,1346.92,0,0,0,312,37.8696,95.3309,0,0,0,312,37.8696,95.3309,528,120300,373696,0.321919,0.00438903,1,1334,264.639,2.93281,1334,264.639,2.93281,5318,1041.67,11.7313,5318,1041.67,2.93281,1, /home/tomas/GitRepos/Gitforks/hapori/benchmarks/childsnack-strips/1-p29.pddl,346,49692,3,31,10.333333,-25,-0.00289,1.38843,1,1.0,0.0,0.128471,0.00491,31,119,1,119,119,32,26,29,31,3,55,52,0.945455,29,26,0,0.945455,10,1.73205,0.945455,2,0,2,2,184,2,0,0,0,31,1-p29.pddl
child-snack,prob-snack,2,7,141,14,0,196,27,6,0,0,41,57115,1684,58799,128620,0,106380,0,191,0,548,164,440,56238,404172,191,27,11610,372924,0.0164513,32.1209,1952.48,0.141361,135,60.7853,46.5371,110,60.7853,24.0989,5508,1952.48,1952.76,4644,1952.48,1468.39,0,0,0,324,39.5812,99.5697,0,0,0,324,39.5812,99.5697,548,135294,421062,0.321316,0.00405044,1,1440,287.391,3.0231,1440,287.391,3.0231,5742,1132.67,12.0924,5742,1132.67,3.0231,1, /home/tomas/GitRepos/Gitforks/hapori/benchmarks/childsnack-strips/1-p30.pddl,359,56246,3,32,10.666667,-26,-0.002786,1.415195,1,1.0,0.0,0.121609,0.00448,32,124,1,124,124,33,27,30,32,3,57,54,0.947368,30,27,0,0.947368,13,2.0,0.947368,2,0,2,2,191,2,0,0,0,32,1-p30.pddl
child-snack,prob-snack,2,7,32,14,0,38,6,6,0,0,41,643,292,935,1387,0,640,0,36,0,100,26,72,456,3134,36,6,404,2384,0.0891089,5.90099,66.2222,0.166667,22,11.2222,8.03157,18,11.2222,4.90528,144,66.2222,51.2809,128,66.2222,43.4863,0,0,0,48,6.22222,14.25,0,0,0,48,6.22222,14.25,100,1080,3192,0.338346,0.0925926,1,30,9.4,0.162037,30,9.01111,0.0,102,24.0667,0.162037,102,23.6778,0.0,1, /home/tomas/GitRepos/Gitforks/hapori/benchmarks/childsnack-strips/2-child-snack_pfile01-2.pddl,66,464,3,11,3.666667,-5,-0.015152,0.843737,1,1.0,0.0,1.0,0.146552,11,26,1,26,26,12,6,9,11,3,15,12,0.8,9,6,0,0.8,3,0.0,0.8,2,0,2,2,36,2,0,0,0,11,2-child-snack_pfile01-2.pddl
child-snack,prob-snack,2,7,32,14,0,38,6,6,0,0,41,643,292,935,1387,0,640,0,36,0,100,26,72,456,3134,36,6,404,2384,0.0891089,5.90099,66.2222,0.166667,22,11.2222,8.03157,18,11.2222,4.90528,144,66.2222,51.2809,128,66.2222,43.4863,0,0,0,48,6.22222,14.25,0,0,0,48,6.22222,14.25,100,1064,3160,0.336709,0.093985,1,30,9.31111,0.162037,30,8.92222,0.0,102,23.7111,0.162037,102,23.3222,0.0,1, /home/tomas/GitRepos/Gitforks/hapori/benchmarks/childsnack-strips/2-child-snack_pfile01.pddl,66,464,3,10,3.333333,-5,-0.015152,0.788024,1,1.0,0.0,0.926724,0.073276,8,26,1,26,26,11,6,8,10,3,14,12,0.857143,8,6,0,0.857143,4,0.0,0.857143,2,0,2,2,36,2,0,0,0,10,2-child-snack_pfile01.pddl
child-snack,prob-snack,2,7,37,14,0,44,7,6,0,0,41,931,352,1283,1992,0,1060,0,43,0,120,32,88,714,4900,43,7,562,3820,0.0765125,6.79715,88.8372,0.162791,27,13.0698,9.60716,22,13.0698,5.96266,200,88.8372,70.8818,180,88.8372,61.3116,0,0,0,60,7.44186,17.2658,0,0,0,60,7.44186,17.2658,120,1754,5214,0.336402,0.0684151,1,50,13.6744,0.0,50,12.9535,0.0,178,39.4419,0.0,178,38.3953,0.0,1, /home/tomas/GitRepos/Gitforks/hapori/benchmarks/childsnack-strips/2-child-snack_pfile02-2.pddl,79,722,3,12,4.0,-6,-0.012658,0.864104,1,1.0,0.0,0.808864,0.105263,12,30,1,30,30,13,7,10,12,3,17,14,0.823529,10,7,0,0.823529,3,0.0,0.823529,2,0,2,2,43,2,0,0,0,12,2-child-snack_pfile02-2.pddl
child-snack,prob-snack,2,7,37,14,0,44,7,6,0,0,41,931,352,1283,1992,0,1060,0,43,0,120,32,88,714,4900,43,7,562,3820,0.0765125,6.79715,88.8372,0.162791,27,13.0698,9.60716,22,13.0698,5.96266,200,88.8372,70.8818,180,88.8372,61.3116,0,0,0,60,7.44186,17.2658,0,0,0,60,7.44186,17.2658,120,1734,5174,0.335137,0.0692042,1,50,13.5814,0.0,50,12.8605,0.0,178,39.0698,0.0,178,38.0233,0.0,1, /home/tomas/GitRepos/Gitforks/hapori/benchmarks/childsnack-strips/2-child-snack_pfile02.pddl,79,722,3,11,3.666667,-6,-0.012658,0.818979,1,1.0,0.0,0.756233,0.052632,9,30,1,30,30,12,7,9,11,3,16,14,0.875,9,7,0,0.875,5,1.0,0.875,2,0,2,2,43,2,0,0,0,11,2-child-snack_pfile02.pddl
child-snack,prob-snack,2,7,41,14,0,51,8,6,0,0,41,1266,388,1654,2728,0,1606,0,48,0,133,35,96,1025,7111,48,8,727,5797,0.0660248,7.97387,120.771,0.166667,30,15.1458,10.9658,24,15.1458,6.2048,275,120.771,97.5293,242,120.771,80.3252,0,0,0,66,8.70833,19.952,0,0,0,66,8.70833,19.952,133,2499,7526,0.332049,0.0532213,1,70,17.7792,0.0,70,17.4667,0.0706653,262,56.3792,0.0,262,56.0667,0.0706653,1, /home/tomas/GitRepos/Gitforks/hapori/benchmarks/childsnack-strips/2-child-snack_pfile03-2.pddl,87,1033,3,13,4.333333,-7,-0.011494,0.915941,1,1.0,0.0,0.650532,0.077444,13,35,1,35,35,14,8,11,13,3,19,16,0.842105,11,8,0,0.842105,4,0.0,0.842105,2,0,2,2,48,2,0,0,0,13,2-child-snack_pfile03-2.pddl
child-snack,prob-snack,2,7,41,14,0,51,8,6,0,0,41,1266,388,1654,2728,0,1606,0,48,0,133,35,96,1025,7111,48,8,727,5797,0.0660248,7.97387,120.771,0.166667,30,15.1458,10.9658,24,15.1458,6.2048,275,120.771,97.5293,242,120.771,80.3252,0,0,0,66,8.70833,19.952,0,0,0,66,8.70833,19.952,133,2499,7548,0.331081,0.0532213,1,70,17.7792,0.0,70,17.4667,0.0706653,262,56.3792,0.0,262,56.0667,0.0706653,1, /home/tomas/GitRepos/Gitforks/hapori/benchmarks/childsnack-strips/2-child-snack_pfile03.pddl,87,1033,3,13,4.333333,-7,-0.011494,0.915941,1,1.0,0.0,0.650532,0.077444,13,35,1,35,35,14,8,11,13,3,19,16,0.842105,11,8,0,0.842105,4,0.0,0.842105,2,0,2,2,48,2,0,0,0,13,2-child-snack_pfile03.pddl
child-snack,prob-snack,2,7,46,14,0,57,9,6,0,0,41,1762,568,2330,3848,0,2160,0,54,0,162,39,120,1476,9993,54,9,897,8028,0.0602007,8.94983,148.667,0.166667,33,16.6111,12.0561,27,16.6111,7.41724,324,148.667,115.144,288,148.667,97.6024,0,0,0,108,14.0,32.0624,0,0,0,108,14.0,32.0624,162,3528,10584,0.333333,0.0459184,1,81,20.7778,0.0,81,20.5556,0.0,297,63.1111,0.0,297,62.8889,0.0,1, /home/tomas/GitRepos/Gitforks/hapori/benchmarks/childsnack-strips/2-child-snack_pfile04-2.pddl,111,1488,3,14,4.666667,-8,-0.009009,0.895389,1,1.0,0.0,0.774194,0.084677,14,39,1,39,39,15,9,12,14,3,21,18,0.857143,12,9,0,0.857143,4,0.0,0.857143,2,0,3,3,54,3,0,0,0,14,2-child-snack_pfile04-2.pddl
child-snack,prob-snack,2,7,46,14,0,57,9,6,0,0,41,1762,568,2330,3848,0,2160,0,54,0,162,39,120,1476,9993,54,9,897,8028,0.0602007,8.94983,148.667,0.166667,33,16.6111,12.0561,27,16.6111,7.41724,324,148.667,115.144,288,148.667,97.6024,0,0,0,108,14.0,32.0624,0,0,0,108,14.0,32.0624,162,3528,10584,0.333333,0.0459184,1,81,20.7778,0.0,81,20.5556,0.0,297,63.1111,0.0,297,62.8889,0.0,1, /home/tomas/GitRepos/Gitforks/hapori/benchmarks/childsnack-strips/2-child-snack_pfile04.pddl,111,1488,3,14,4.666667,-8,-0.009009,0.895389,1,1.0,0.0,0.774194,0.084677,14,39,1,39,39,15,9,12,14,3,21,18,0.857143,12,9,0,0.857143,4,0.0,0.857143,2,0,3,3,54,3,0,0,0,14,2-child-snack_pfile04.pddl
child-snack,prob-snack,2,7,50,14,0,64,10,6,0,0,41,2284,615,2899,5008,0,3016,0,59,0,176,42,129,1973,13508,59,10,1101,11193,0.0535876,10.1662,189.712,0.169492,36,18.661,13.3881,29,18.661,7.67477,416,189.712,148.893,364,189.712,121.181,0,0,0,117,15.8644,35.9875,0,0,0,117,15.8644,35.9875,176,4690,14206,0.330142,0.0375267,1,103,26.1299,0.191973,103,25.9096,0.191973,385,83.0621,0.767894,385,82.8418,0.191973,1, /home/tomas/GitRepos/Gitforks/hapori/benchmarks/childsnack-strips/2-child-snack_pfile05-2.pddl,120,1985,3,15,5.0,-9,-0.008333,0.944244,1,1.0,0.0,0.658942,0.066499,15,44,1,44,44,16,10,13,15,3,23,20,0.869565,13,10,0,0.869565,4,0.0,0.869565,2,0,3,3,59,3,0,0,0,15,2-child-snack_pfile05-2.pddl
child-snack,prob-snack,2,7,50,14,0,64,10,6,0,0,41,2284,615,2899,5008,0,3016,0,59,0,176,42,129,1973,13508,59,10,1101,11193,0.0535876,10.1662,189.712,0.169492,36,18.661,13.3881,29,18.661,7.67477,416,189.712,148.893,364,189.712,121.181,0,0,0,117,15.8644,35.9875,0,0,0,117,15.8644,35.9875,176,4690,14206,0.330142,0.0375267,1,103,26.1299,0.191973,103,25.9096,0.191973,385,83.0621,0.767894,385,82.8418,0.191973,1, /home/tomas/GitRepos/Gitforks/hapori/benchmarks/childsnack-strips/2-child-snack_pfile05.pddl,120,1985,3,15,5.0,-9,-0.008333,0.944244,1,1.0,0.0,0.658942,0.066499,15,44,1,44,44,16,10,13,15,3,23,20,0.869565,13,10,0,0.869565,5,1.0,0.869565,2,0,3,3,59,3,0,0,0,15,2-child-snack_pfile05.pddl
child-snack,prob-snack,2,7,55,14,0,70,11,6,0,0,41,2974,697,3671,6459,0,4110,0,66,0,198,48,147,2631,17990,66,11,1355,14940,0.0487085,11.0258,226.364,0.166667,41,20.5303,14.9931,33,20.5303,8.73207,510,226.364,180.663,450,226.364,149.856,0,0,0,135,17.7273,40.6126,0,0,0,135,17.7273,40.6126,198,6396,19356,0.33044,0.0309568,1,138,33.0606,0.545519,138,32.8333,0.545519,525,110.833,2.18208,525,110.606,0.545519,1, /home/tomas/GitRepos/Gitforks/hapori/benchmarks/childsnack-strips/2-child-snack_pfile06-2.pddl,135,2643,3,16,5.333333,-10,-0.007407,0.96989,1,1.0,0.0,0.592508,0.054484,16,48,1,48,48,17,11,14,16,3,25,22,0.88,14,11,0,0.88,4,0.0,0.88,2,0,3,3,66,3,0,0,0,16,2-child-snack_pfile06-2.pddl
child-snack,prob-snack,2,7,55,14,0,70,11,6,0,0,41,2974,697,3671,6459,0,4110,0,66,0,198,48,147,2631,17990,66,11,1355,14940,0.0487085,11.0258,226.364,0.166667,41,20.5303,14.9931,33,20.5303,8.73207,510,226.364,180.663,450,226.364,149.856,0,0,0,135,17.7273,40.6126,0,0,0,135,17.7273,40.6126,198,6396,19401,0.329674,0.0309568,1,138,33.0606,0.545519,138,32.8333,0.545519,525,110.833,2.18208,525,110.606,0.545519,1, /home/tomas/GitRepos/Gitforks/hapori/benchmarks/childsnack-strips/2-child-snack_pfile06.pddl,135,2643,3,16,5.333333,-10,-0.007407,0.96989,1,1.0,0.0,0.592508,0.054484,16,48,1,48,48,17,11,14,16,3,25,22,0.88,14,11,0,0.88,5,1.0,0.88,2,0,3,3,66,3,0,0,0,16,2-child-snack_pfile06.pddl
child-snack,prob-snack,2,7,59,14,0,75,12,6,0,0,41,3586,742,4328,7715,0,5120,0,71,0,212,51,156,3220,21999,71,12,1556,18288,0.0456298,11.7532,257.577,0.169014,44,21.9155,16.1801,35,21.9155,9.45225,576,257.577,205.772,512,257.577,173.679,0,0,0,144,18.9296,42.9921,0,0,0,144,18.9296,42.9921,212,7972,24100,0.330788,0.0265931,1,165,39.0563,0.70204,165,38.831,0.70204,633,134.718,2.80816,633,134.493,0.70204,1, /home/tomas/GitRepos/Gitforks/hapori/benchmarks/childsnack-strips/2-child-snack_pfile07-2.pddl,144,3232,3,17,5.666667,-11,-0.006944,1.017189,1,1.0,0.0,0.542079,0.046411,17,52,1,52,52,18,12,15,17,3,27,24,0.888889,15,12,0,0.888889,5,1.0,0.888889,2,0,3,3,71,3,0,0,0,17,2-child-snack_pfile07-2.pddl
child-snack,prob-snack,2,7,59,14,0,75,12,6,0,0,41,3586,742,4328,7715,0,5120,0,71,0,212,51,156,3220,21999,71,12,1556,18288,0.0456298,11.7532,257.577,0.169014,44,21.9155,16.1801,35,21.9155,9.45225,576,257.577,205.772,512,257.577,173.679,0,0,0,144,18.9296,42.9921,0,0,0,144,18.9296,42.9921,212,7972,24148,0.330131,0.0265931,1,165,39.0563,0.70204,165,38.831,0.70204,633,134.718,2.80816,633,134.493,0.70204,1, /home/tomas/GitRepos/Gitforks/hapori/benchmarks/childsnack-strips/2-child-snack_pfile07.pddl,144,3232,3,17,5.666667,-11,-0.006944,1.017189,1,1.0,0.0,0.542079,0.046411,17,52,1,52,52,18,12,15,17,3,27,24,0.888889,15,12,0,0.888889,6,1.0,0.888889,2,0,3,3,71,3,0,0,0,17,2-child-snack_pfile07.pddl
child-snack,prob-snack,2,7,63,14,0,82,13,6,0,0,41,4439,789,5228,9606,0,6596,0,76,0,226,54,165,4048,27873,76,13,1822,23613,0.0417124,12.9599,310.697,0.171053,47,23.9737,17.5176,37,23.9737,9.68038,697,310.697,250.471,612,310.697,205.102,0,0,0,153,20.8026,46.9305,0,0,0,153,20.8026,46.9305,226,9947,30245,0.328881,0.0227204,1,194,45.8662,0.848989,194,45.8662,0.848989,749,160.866,3.39596,749,160.866,0.848989,1, /home/tomas/GitRepos/Gitforks/hapori/benchmarks/childsnack-strips/2-child-snack_pfile08-2.pddl,153,4060,3,18,6.0,-12,-0.006536,1.063333,1,1.0,0.0,0.480296,0.038424,18,57,1,57,57,19,13,16,18,3,29,26,0.896552,16,13,0,0.896552,6,1.0,0.896552,2,0,3,3,76,3,0,0,0,18,2-child-snack_pfile08-2.pddl
child-snack,prob-snack,2,7,63,14,0,82,13,6,0,0,41,4439,789,5228,9606,0,6596,0,76,0,226,54,165,4048,27873,76,13,1822,23613,0.0417124,12.9599,310.697,0.171053,47,23.9737,17.5176,37,23.9737,9.68038,697,310.697,250.471,612,310.697,205.102,0,0,0,153,20.8026,46.9305,0,0,0,153,20.8026,46.9305,226,9947,30296,0.328327,0.0227204,1,194,45.8662,0.848989,194,45.8662,0.848989,749,160.866,3.39596,749,160.866,0.848989,1, /home/tomas/GitRepos/Gitforks/hapori/benchmarks/childsnack-strips/2-child-snack_pfile08.pddl,153,4060,3,18,6.0,-12,-0.006536,1.063333,1,1.0,0.0,0.480296,0.038424,18,57,1,57,57,19,13,16,18,3,29,26,0.896552,16,13,0,0.896552,6,1.0,0.896552,2,0,3,3,76,3,0,0,0,18,2-child-snack_pfile08.pddl
child-snack,prob-snack,2,7,68,14,0,88,14,6,0,0,41,5513,871,6384,11843,0,8398,0,83,0,248,60,183,5090,35007,83,14,2144,29640,0.0387127,13.8246,357.108,0.168675,52,25.8313,19.1197,41,25.8313,10.769,817,357.108,291.136,722,357.108,242.495,0,0,0,171,22.6627,51.5472,0,0,0,171,22.6627,51.5472,248,12709,38644,0.328874,0.0195137,1,239,54.6526,1.13864,239,54.6526,1.13864,929,196.038,4.55456,929,196.038,1.13864,1, /home/tomas/GitRepos/Gitforks/hapori/benchmarks/childsnack-strips/2-child-snack_pfile09-2.pddl,168,5102,3,19,6.333333,-13,-0.005952,1.088342,1,1.0,0.0,0.444532,0.032928,19,61,1,61,61,20,14,17,19,3,31,28,0.903226,17,14,0,0.903226,6,1.0,0.903226,2,0,3,3,83,3,0,0,0,19,2-child-snack_pfile09-2.pddl
child-snack,prob-snack,2,7,68,14,0,88,14,6,0,0,41,5513,871,6384,11843,0,8398,0,83,0,248,60,183,5090,35007,83,14,2144,29640,0.0387127,13.8246,357.108,0.168675,52,25.8313,19.1197,41,25.8313,10.769,817,357.108,291.136,722,357.108,242.495,0,0,0,171,22.6627,51.5472,0,0,0,171,22.6627,51.5472,248,12709,38587,0.32936,0.0195137,1,239,54.6526,1.13864,239,54.6526,1.13864,929,196.038,4.55456,929,196.038,1.13864,1, /home/tomas/GitRepos/Gitforks/hapori/benchmarks/childsnack-strips/2-child-snack_pfile09.pddl,168,5102,3,19,6.333333,-13,-0.005952,1.088342,1,1.0,0.0,0.444532,0.032928,19,61,1,61,61,20,14,17,19,3,31,28,0.903226,17,14,0,0.903226,6,1.0,0.903226,2,0,3,3,83,3,0,0,0,19,2-child-snack_pfile09.pddl
child-snack,prob-snack,2,7,72,14,0,95,15,6,0,0,41,6664,918,7582,14406,0,10440,0,88,0,262,63,192,6216,43025,88,15,2455,36960,0.0358452,15.055,420.0,0.170455,55,27.8977,20.4595,43,27.8977,10.9835,960,420.0,344.886,840,420.0,279.938,0,0,0,180,24.5455,55.4918,0,0,0,180,24.5455,55.4918,262,15396,46956,0.327881,0.0170174,1,273,62.7727,1.26467,273,62.7727,1.26467,1065,226.75,5.05867,1065,226.75,1.26467,1, /home/tomas/GitRepos/Gitforks/hapori/benchmarks/childsnack-strips/2-child-snack_pfile10-2.pddl,177,6228,3,20,6.666667,-14,-0.00565,1.132455,1,1.0,0.0,0.400771,0.027938,20,66,1,66,66,21,15,18,20,3,33,30,0.909091,18,15,0,0.909091,7,1.0,0.909091,2,0,3,3,88,3,0,0,0,20,2-child-snack_pfile10-2.pddl
child-snack,prob-snack,2,7,72,14,0,95,15,6,0,0,41,6664,918,7582,14406,0,10440,0,88,0,262,63,192,6216,43025,88,15,2455,36960,0.0358452,15.055,420.0,0.170455,55,27.8977,20.4595,43,27.8977,10.9835,960,420.0,344.886,840,420.0,279.938,0,0,0,180,24.5455,55.4918,0,0,0,180,24.5455,55.4918,262,15396,46956,0.327881,0.0170174,1,273,62.7727,1.26467,273,62.7727,1.26467,1065,226.75,5.05867,1065,226.75,1.26467,1, /home/tomas/GitRepos/Gitforks/hapori/benchmarks/childsnack-strips/2-child-snack_pfile10.pddl,177,6228,3,20,6.666667,-14,-0.00565,1.132455,1,1.0,0.0,0.400771,0.027938,20,66,1,66,66,21,15,18,20,3,33,30,0.909091,18,15,0,0.909091,8,1.0,0.909091,2,0,3,3,88,3,0,0,0,20,2-child-snack_pfile10.pddl
child-snack,prob-snack,2,7,76,14,0,100,16,6,0,0,41,7710,963,8673,16550,0,12264,0,93,0,276,66,201,7239,50044,93,16,2723,42903,0.0341535,15.7558,461.323,0.172043,58,29.2796,21.6464,45,29.2796,11.711,1050,461.323,378.285,924,461.323,312.077,0,0,0,189,25.7419,57.8708,0,0,0,189,25.7419,57.8708,276,18180,55350,0.328455,0.0151815,1,309,70.7957,1.38483,309,70.7957,1.38483,1209,258.796,5.53933,1209,258.796,1.38483,1, /home/tomas/GitRepos/Gitforks/hapori/benchmarks/childsnack-strips/3-child-snack_pfile11-2.pddl,186,7251,3,21,7.0,-15,-0.005376,1.175454,1,1.0,0.0,0.377327,0.024824,21,70,1,70,70,22,16,19,21,3,35,32,0.914286,19,16,0,0.914286,7,1.0,0.914286,2,0,3,3,93,3,0,0,0,21,3-child-snack_pfile11-2.pddl
child-snack,prob-snack,2,7,76,14,0,100,16,6,0,0,41,7710,963,8673,16550,0,12264,0,93,0,276,66,201,7239,50044,93,16,2723,42903,0.0341535,15.7558,461.323,0.172043,58,29.2796,21.6464,45,29.2796,11.711,1050,461.323,378.285,924,461.323,312.077,0,0,0,189,25.7419,57.8708,0,0,0,189,25.7419,57.8708,276,18180,55350,0.328455,0.0151815,1,309,70.7957,1.38483,309,70.7957,1.38483,1209,258.796,5.53933,1209,258.796,1.38483,1, /home/tomas/GitRepos/Gitforks/hapori/benchmarks/childsnack-strips/3-child-snack_pfile11.pddl,186,7251,3,21,7.0,-15,-0.005376,1.175454,1,1.0,0.0,0.377327,0.024824,21,70,1,70,70,22,16,19,21,3,35,32,0.914286,19,16,0,0.914286,8,1.0,0.914286,2,0,3,3,93,3,0,0,0,21,3-child-snack_pfile11.pddl
child-snack,prob-snack,2,7,82,14,0,107,17,6,0,0,41,9716,1312,11028,20884,0,14950,0,101,0,325,73,246,9179,62726,101,17,3153,53222,0.032033,16.8798,526.95,0.168317,63,31.2178,23.1477,50,31.2178,13.2975,1196,526.95,425.594,1058,526.95,355.134,0,0,0,276,36.4356,82.9761,0,0,0,276,36.4356,82.9761,325,22749,69163,0.328919,0.0142863,1,355,79.5856,2.16741,355,79.5856,2.16741,1384,288.975,8.66963,1384,288.975,2.16741,1, /home/tomas/GitRepos/Gitforks/hapori/benchmarks/childsnack-strips/3-child-snack_pfile12.pddl,228,9195,3,22,7.333333,-16,-0.004386,1.125844,1,1.0,0.0,0.45155,0.027841,22,74,1,74,74,23,17,20,22,3,37,34,0.918919,20,17,0,0.918919,8,1.41421,0.918919,2,0,4,4,101,4,0,0,0,22,3-child-snack_pfile12.pddl
child-snack,prob-snack,2,7,86,14,0,114,18,6,0,0,41,11387,1370,12757,24599,0,17904,0,106,0,340,76,256,10824,74400,106,18,3528,63864,0.0300454,18.102,602.491,0.169811,66,33.283,24.4875,52,33.283,13.5206,1368,602.491,489.661,1200,602.491,399.884,0,0,0,288,38.9434,88.2403,0,0,0,288,38.9434,88.2403,340,26664,81360,0.327729,0.0127513,1,396,89.3369,2.30909,396,89.3369,2.30909,1548,325.86,9.23638,1548,325.86,2.30909,1, /home/tomas/GitRepos/Gitforks/hapori/benchmarks/childsnack-strips/3-child-snack_pfile13-2.pddl,238,10840,3,23,7.666667,-17,-0.004202,1.164957,1,1.0,0.0,0.416236,0.024354,23,79,1,79,79,24,18,21,23,3,39,36,0.923077,21,18,0,0.923077,7,1.0,0.923077,2,0,4,4,106,4,0,0,0,23,3-child-snack_pfile13-2.pddl
child-snack,prob-snack,2,7,86,14,0,114,18,6,0,0,41,11387,1370,12757,24599,0,17904,0,106,0,340,76,256,10824,74400,106,18,3528,63864,0.0300454,18.102,602.491,0.169811,66,33.283,24.4875,52,33.283,13.5206,1368,602.491,489.661,1200,602.491,399.884,0,0,0,288,38.9434,88.2403,0,0,0,288,38.9434,88.2403,340,26664,81360,0.327729,0.0127513,1,396,89.3369,2.30909,396,89.3369,2.30909,1548,325.86,9.23638,1548,325.86,2.30909,1, /home/tomas/GitRepos/Gitforks/hapori/benchmarks/childsnack-strips/3-child-snack_pfile13.pddl,238,10840,3,23,7.666667,-17,-0.004202,1.164957,1,1.0,0.0,0.416236,0.024354,23,79,1,79,79,24,18,21,23,3,39,36,0.923077,21,18,0,0.923077,9,1.41421,0.923077,2,0,4,4,106,4,0,0,0,23,3-child-snack_pfile13.pddl
child-snack,prob-snack,2,7,90,14,0,119,19,6,0,0,41,12885,1426,14311,27669,0,20500,0,111,0,355,79,266,12298,84470,111,19,3848,72375,0.0288462,18.8085,652.027,0.171171,69,34.6667,25.6737,54,34.6667,14.2452,1475,652.027,529.617,1300,652.027,438.151,0,0,0,300,40.5405,91.4137,0,0,0,300,40.5405,91.4137,355,30648,93373,0.328232,0.0115831,1,439,98.7561,2.44558,439,98.7561,2.44558,1720,363.472,9.78231,1720,363.472,2.44558,1, /home/tomas/GitRepos/Gitforks/hapori/benchmarks/childsnack-strips/3-child-snack_pfile14.pddl,248,12314,3,24,8.0,-18,-0.004032,1.203148,1,1.0,0.0,0.396947,0.022089,24,83,1,83,83,25,19,22,24,3,41,38,0.926829,22,19,0,0.926829,9,1.41421,0.926829,2,0,4,4,111,4,0,0,0,24,3-child-snack_pfile14.pddl
child-snack,prob-snack,2,7,94,14,0,126,20,6,0,0,41,14909,1484,16393,32181,0,24128,0,116,0,370,82,276,14296,98686,116,20,4260,85384,0.02723,20.0432,736.069,0.172414,72,36.7241,27.0056,56,36.7241,14.4578,1664,736.069,601.313,1456,736.069,487.99,0,0,0,312,43.0345,96.6281,0,0,0,312,43.0345,96.6281,370,35408,108208,0.327222,0.0104496,1,484,110.32,2.57732,484,110.32,2.57732,1900,409.67,10.3093,1900,409.67,2.57732,1, /home/tomas/GitRepos/Gitforks/hapori/benchmarks/childsnack-strips/3-child-snack_pfile15-2.pddl,258,14312,3,25,8.333333,-19,-0.003876,1.240461,1,1.0,0.0,0.368921,0.019564,25,88,1,88,88,26,20,23,25,3,43,40,0.930233,23,20,0,0.930233,7,1.41421,0.930233,2,0,4,4,116,4,0,0,0,25,3-child-snack_pfile15-2.pddl
child-snack,prob-snack,2,7,99,14,0,132,21,6,0,0,41,17299,1588,18887,37146,0,28280,0,123,0,394,88,296,16652,114854,123,21,4746,99176,0.0259166,20.8968,806.309,0.170732,77,38.5854,28.6163,60,38.5854,15.5579,1848,806.309,663.158,1624,806.309,544.968,0,0,0,336,45.5285,102.826,0,0,0,336,45.5285,102.826,394,41684,127196,0.327715,0.00945207,1,552,123.317,2.86188,552,123.317,2.86188,2172,461.659,11.4475,2172,461.659,2.86188,1, /home/tomas/GitRepos/Gitforks/hapori/benchmarks/childsnack-strips/3-child-snack_pfile16-2.pddl,275,16668,3,26,8.666667,-20,-0.003636,1.260586,1,1.0,0.0,0.353252,0.017759,26,92,1,92,92,27,21,24,26,3,45,42,0.933333,24,21,0,0.933333,7,1.41421,0.933333,2,0,4,4,123,4,0,0,0,26,3-child-snack_pfile16-2.pddl
child-snack,prob-snack,2,7,112,14,0,150,24,6,0,0,41,25003,1806,26809,53461,0,42048,0,140,0,448,100,336,24272,167876,140,24,6144,145568,0.0227865,23.6927,1039.77,0.171429,88,43.8857,32.7447,68,43.8857,17.6048,2400,1039.77,862.887,2112,1039.77,713.097,0,0,0,384,52.1143,117.41,0,0,0,384,52.1143,117.41,448,61520,187696,0.327764,0.00728218,1,732,162.388,3.35647,732,162.388,3.35647,2892,617.849,13.4259,2892,617.849,3.35647,1, /home/tomas/GitRepos/Gitforks/hapori/benchmarks/childsnack-strips/3-child-snack_pfile19-2.pddl,312,24288,3,29,9.666667,-23,-0.003205,1.350447,1,1.0,0.0,0.306983,0.013505,29,105,1,105,105,30,24,27,29,3,51,48,0.941176,27,24,0,0.941176,11,1.73205,0.941176,2,0,4,4,140,4,0,0,0,29,3-child-snack_pfile19-2.pddl
child-snack,prob-snack,2,7,112,14,0,150,24,6,0,0,41,25003,1806,26809,53461,0,42048,0,140,0,448,100,336,24272,167876,140,24,6144,145568,0.0227865,23.6927,1039.77,0.171429,88,43.8857,32.7447,68,43.8857,17.6048,2400,1039.77,862.887,2112,1039.77,713.097,0,0,0,384,52.1143,117.41,0,0,0,384,52.1143,117.41,448,61520,187696,0.327764,0.00728218,1,732,162.388,3.35647,732,162.388,3.35647,2892,617.849,13.4259,2892,617.849,3.35647,1, /home/tomas/GitRepos/Gitforks/hapori/benchmarks/childsnack-strips/3-child-snack_pfile19.pddl,312,24288,3,29,9.666667,-23,-0.003205,1.350447,1,1.0,0.0,0.306983,0.013505,29,105,1,105,105,30,24,27,29,3,51,48,0.941176,27,24,0,0.941176,11,1.73205,0.941176,2,0,4,4,140,4,0,0,0,29,3-child-snack_pfile19.pddl
