domain,task_name,requirements,types,objects,predicates,functions,init,goal,actions,axioms,use_min_cost_metric,generated_rules,relevant_atoms,auxiliary_atoms,final_queue_length,total_queue_pushes,implied_effects_removed,effect_conditions_simplified,implied_preconditions_added,translator_variables,translator_derived_variables,translator_facts,translator_mutex_groups,translator_total_mutex_groups_size,translator_operators,translator_task_size,numberVariablesCG,highLevelVariablesCG,totalEdgesCG,totalWeightCG,veRatio,weRatio,wvRatio,hvRatio,inputEdgeCGMax,inputEdgeCGAvg,inputEdgeCGStd,outputEdgeCGMax,outputEdgeCGAvg,outputEdgeCGStd,inputWeightCGMax,inputWeightCGAvg,inputWeightCGStd,outputWeightCGMax,outputWeightCGAvg,outputWeightCGStd,inputEdgeHVMax,inputEdgeHVAvg,inputEdgeHVStd,outputEdgeHVMax,outputEdgeHVAvg,outputEdgeHVStd,inputWeightHVMax,inputWeightHVAvg,inputWeightHVStd,outputWeightHVMax,outputWeightHVAvg,outputWeightHVStd,numberVariablesDTG,totalEdgesDTG,totalWeigthDTG,edVaRatioDTG,weEdRatioDTG,weVaRatioDTG,inputEdgeDTGMax,inputEdgeDTGAvg,inputEdgeDTGStd,outputEdgeDTGMax,outputEdgeDTGAvg,outputEdgeDTGStd,inputWeightDTGMax,inputWeightDTGAvg,inputWeightDTGStd,outputWeightDTGMax,outputWeightDTGAvg,outputWeightDTGStd,no,file,num_relevant_facts,num_actions,h_max,h_ff,h_ff_ratio,rp_fact_balance_min,rp_fact_balance_avg,rp_fact_balance_var,rp_goal_balance_min,rp_goal_balance_avg,rp_goal_balance_var,balance_Ratio,Unbalance_Ratio,Balance_Distorsion,Additive ,Blind,Causal_graph,Context-enhanced_additive,FF,Goal_count,Landmark_count,Landmark-cut,Max,n_landmarks,numberEdges,edVaratioLand,numberFatherNodes,numberChildrenNodes,nodosbetween,avginput,maxinput,stdinput,avgoutput,maxoutput,stdoutput,blackVariables,blackRootVariables,redBlackVariables,allpairsvaluesconnected,allvaluesconnectedgoal,blackstronglpyarents,Maximaleffectsblack,Hred-black,problem_name
no-mystery-strips,strips-mysty-x-1,1,1,21,13,0,54,1,3,0,0,42,295,285,580,835,0,0,0,11,0,58,11,58,151,990,11,1,22,517,0.5,23.5,47.0,0.0909091,10,2.0,2.5937,6,2.0,1.53741,259,47.0,73.0492,216,47.0,60.3339,1,0.0909091,0.28748,72,6.54545,20.6985,36,3.27273,10.3493,72,6.54545,20.6985,58,279,774,0.360465,0.207885,1,20,3.69719,1.1103,16,3.71234,0.919989,46,7.87165,2.2206,35,7.6974,0.919989,1.0, /home/tomas/GitRepos/Gitforks/hapori/benchmarks/no-mystery-strips/0-prob01.pddl,58.0,151.0,4.0,5.0,1.25,-1.0,0.0,0.415227,1.0,1.0,0.0,2.516556,0.0,0.0,6,1,6,5,5,1,6,4,4,10,21,2.1,4,1,5,2.1,5,1.0,2.1,9,2.44949,2.0,0,11,0,0,0,1,5,0-prob01.pddl
no-mystery-strips,strips-mysty-x-2,1,1,40,13,0,102,2,3,0,0,42,4036,1687,5723,12658,0,0,0,35,0,292,35,292,3596,21961,35,2,300,13912,0.116667,46.3733,397.486,0.0571429,28,8.57143,8.61323,21,8.57143,4.7225,1739,397.486,533.515,1680,397.486,479.297,4,0.228571,0.928462,336,19.2,77.9908,168,9.6,38.9954,336,19.2,77.9908,292,7040,20800,0.338462,0.0414773,1,112,20.6791,2.51384,104,21.022,2.30211,260,45.9296,5.02768,244,46.1582,2.30211,1.0, /home/tomas/GitRepos/Gitforks/hapori/benchmarks/no-mystery-strips/0-prob02.pddl,292.0,3596.0,3.0,9.0,3.0,-2.0,0.0,0.341231,1.0,1.0,0.0,3.014461,0.13515,9.0,9,1,10,9,9,2,6,5,3,8,10,1.25,4,2,2,1.25,2,0.0,1.25,4,1.0,17.0,0,35,0,0,0,4,8,0-prob02.pddl
no-mystery-strips,strips-mysty-x-3,1,1,31,13,0,92,1,3,0,0,42,2016,1407,3423,6590,0,0,0,26,0,211,26,211,1676,10237,26,1,180,6168,0.144444,34.2667,237.231,0.0384615,19,6.92308,5.34159,10,6.92308,2.40069,771,237.231,253.219,704,237.231,243.182,4,0.153846,0.769231,352,13.5385,67.6923,176,6.76923,33.8462,352,13.5385,67.6923,211,3184,9184,0.34669,0.0662688,1,64,13.3909,2.74607,59,13.0319,2.08453,128,26.7818,5.49214,118,26.0639,2.08453,1.0, /home/tomas/GitRepos/Gitforks/hapori/benchmarks/no-mystery-strips/0-prob03.pddl,211.0,1676.0,3.0,5.0,1.666667,-1.0,0.0,0.238479,1.0,1.0,0.0,1.377088,0.150358,1.0,6,1,5,4,5,1,4,4,3,5,6,1.2,3,1,1,1.2,2,0.0,1.2,4,1.41421,5.0,0,26,0,0,0,4,4,0-prob03.pddl
no-mystery-strips,strips-mysty-x-4,1,1,25,13,0,77,1,3,0,0,42,439,547,986,1305,0,0,0,17,0,118,17,118,210,1444,17,1,38,700,0.447368,18.4211,41.1765,0.0588235,16,2.23529,3.71847,8,2.23529,2.15651,350,41.1765,82.9828,280,41.1765,62.6214,1,0.0588235,0.235294,40,2.35294,9.41176,20,1.17647,4.70588,40,2.35294,9.41176,118,371,1022,0.363014,0.318059,1,22,2.07121,0.629431,15,2.27709,0.629431,44,4.31889,1.25886,32,4.67184,0.629431,1.0, /home/tomas/GitRepos/Gitforks/hapori/benchmarks/no-mystery-strips/0-prob04.pddl,118.0,210.0,6.0,9.0,1.5,-2.0,0.0,0.520756,1.0,1.0,0.0,4.161905,0.880952,19.0,12,1,1000,1000,9,1,8,7,6,14,39,2.78571,7,1,6,2.78571,7,1.73205,2.78571,13,3.4641,6.0,0,17,0,0,0,1,7,0-prob04.pddl
no-mystery-strips,strips-mysty-x-5,1,1,35,13,0,90,2,3,0,0,42,2695,1334,4029,8470,0,0,0,28,0,237,28,237,2325,14289,28,2,204,8970,0.137255,43.9706,320.357,0.0714286,22,7.28571,6.43571,16,7.28571,3.79715,1465,320.357,441.871,1440,320.357,407.73,4,0.285714,1.03016,294,21.0,75.7166,150,10.7143,38.6309,294,21.0,75.7166,237,4608,13536,0.340426,0.0514323,1,90,16.0402,2.56262,72,14.942,2.0313,216,35.9375,5.12525,171,32.7768,2.0313,1.0, /home/tomas/GitRepos/Gitforks/hapori/benchmarks/no-mystery-strips/0-prob05.pddl,237.0,2325.0,6.0,8.0,1.333333,-4.0,0.0,0.400422,1.0,1.0,0.0,3.935054,0.616774,11.0,12,1,1000,1000,8,2,8,8,6,13,22,1.69231,6,2,5,1.69231,3,0.0,1.69231,9,2.23607,1.0,0,28,0,0,0,15,8,0-prob05.pddl
no-mystery-strips,strips-mysty-x-6,1,1,50,13,0,157,2,3,0,0,42,11303,5116,16419,36991,0,0,0,46,0,552,46,552,10539,63081,46,2,594,39546,0.0774411,66.5758,859.696,0.0434783,27,12.913,6.99014,20,12.913,4.59123,2185,859.696,783.805,2064,859.696,961.4,11,0.478261,2.24324,2064,89.7391,420.914,1038,45.1304,211.681,2064,89.7391,420.914,552,20331,59130,0.343836,0.0271507,1,198,33.8362,6.99041,165,33.1514,5.98777,396,67.6724,13.9808,330,66.3028,5.98777,1.0, /home/tomas/GitRepos/Gitforks/hapori/benchmarks/no-mystery-strips/0-prob06.pddl,552.0,10539.0,5.0,17.0,3.4,-3.0,0.0,0.361158,1.0,1.0,0.0,4.333807,0.212923,40.0,14,1,17,15,14,2,2,6,5,4,2,0.5,2,2,0,0.5,1,0.0,0.5,1,0.0,3.0,0,46,0,0,0,9,14,0-prob06.pddl
no-mystery-strips,strips-mysty-x-7,1,1,42,13,0,112,1,3,0,0,42,656,824,1480,1929,-1,-1,-1,1,0,2,0,0,0,4,1,1,0,0, ?, ?,0.0,1.0,0,0.0,0.0,0,0.0,0.0,0,0.0,0.0,0,0.0,0.0,0,0.0,0.0,0,0.0,0.0,0,0.0,0.0,0,0.0,0.0,0,0,0, ?, ?, ?,0, ?, ?,0, ?, ?,0, ?,,0,, ?,,,,,,,,,,,,,,,,,1000,1000,1000,1000,1000,1,1000,1000,1000,2,1,0.5,1,1,0,0.5,1,0.0,0.5,1,0.0,,0,0,1,0,0,0,0,0-prob07.pddl
no-mystery-strips,strips-mysty-x-8,1,1,41,13,0,131,1,3,0,0,42,3453,2359,5812,11513,0,0,0,32,0,291,32,291,2980,18065,32,1,250,11060,0.128,44.24,345.625,0.03125,19,7.8125,5.02144,14,7.8125,3.86036,1082,345.625,386.128,1044,345.625,463.075,9,0.28125,1.56593,1044,32.625,181.648,534,16.6875,92.9121,1044,32.625,181.648,291,5785,16670,0.347031,0.0503025,1,95,17.1462,4.82841,105,17.7321,4.85404,190,34.2924,9.65682,210,35.4642,4.85404,1.0, /home/tomas/GitRepos/Gitforks/hapori/benchmarks/no-mystery-strips/0-prob08.pddl,291.0,2980.0,4.0,6.0,1.5,-2.0,0.0,0.274957,1.0,1.0,0.0,0.715436,0.17651,9.0,6,1,1000,1000,6,1,1,5,4,4,3,0.75,3,1,0,0.75,1,0.0,0.75,3,1.0,5.0,0,32,0,0,0,5,5,0-prob08.pddl
no-mystery-strips,strips-mysty-x-9,1,1,33,13,0,82,2,3,0,0,42,2607,1254,3861,8243,0,0,0,27,0,205,27,205,2280,14023,27,2,208,8928,0.129808,42.9231,330.667,0.0740741,20,7.7037,6.01735,14,7.7037,3.06491,1116,330.667,364.688,1092,330.667,349.048,4,0.296296,1.04757,336,24.8889,87.9955,168,12.4444,43.9978,336,24.8889,87.9955,205,4512,13392,0.336918,0.0454344,1,72,18.0541,3.0288,68,15.6837,2.10425,180,42.492,6.60628,160,35.9734,2.10425,1.0, /home/tomas/GitRepos/Gitforks/hapori/benchmarks/no-mystery-strips/0-prob09.pddl,205.0,2280.0,4.0,9.0,2.25,-2.0,0.0,0.407251,1.0,1.0,0.0,3.596491,0.130263,10.0,9,1,9,8,9,2,6,6,4,8,8,1.0,4,2,2,1.0,2,0.0,1.0,3,1.0,10.0,0,27,0,0,0,4,8,0-prob09.pddl
no-mystery-strips,strips-mysty-x-10,1,1,77,13,0,209,1,3,0,0,42,38374,11225,49599,121803,0,0,0,74,0,1346,74,1346,36738,222025,74,1,1310,144612,0.0564885,110.391,1954.22,0.0135135,58,17.7027,17.1328,40,17.7027,9.113,9009,1954.22,2745.54,8892,1954.22,2548.9,9,0.121622,1.03914,1830,24.7297,211.291,918,12.4054,105.992,1830,24.7297,211.291,1346,72924,216984,0.33608,0.0184576,1,366,52.0911,4.76154,318,48.1384,4.18108,828,114.561,9.52307,708,104.061,4.18108,1.0, /home/tomas/GitRepos/Gitforks/hapori/benchmarks/no-mystery-strips/0-prob10.pddl,1346.0,36738.0,4.0,8.0,2.0,-2.0,0.0,0.138984,1.0,1.0,0.0,1.738908,0.202216,9.0,8,1,8,8,8,1,1,5,4,2,1,0.5,1,1,0,0.5,1,0.0,0.5,1,0.0,1.0,0,74,0,0,0,39,8,0-prob10.pddl
no-mystery-strips,strips-mysty-x-11,1,1,26,13,0,71,2,3,0,0,42,527,506,1033,1560,0,0,0,17,0,110,17,110,310,2045,17,2,39,1132,0.435897,29.0256,66.5882,0.117647,16,2.29412,3.80038,9,2.29412,2.16291,566,66.5882,137.053,512,66.5882,114.548,1,0.117647,0.32219,64,7.52941,20.6201,32,3.76471,10.3101,64,7.52941,20.6201,110,586,1684,0.347981,0.187713,1,25,3.59771,0.926365,29,3.77418,0.609773,62,7.90131,1.85273,70,8.25425,0.609773,1.0, /home/tomas/GitRepos/Gitforks/hapori/benchmarks/no-mystery-strips/0-prob11.pddl,110.0,310.0,4.0,8.0,2.0,-2.0,0.0,0.447214,1.0,1.0,0.0,3.106452,0.319355,10.0,13,1,12,10,8,2,8,6,4,13,30,2.30769,6,2,5,2.30769,6,1.41421,2.30769,9,2.82843,6.0,0,17,0,0,0,1,8,0-prob11.pddl
no-mystery-strips,strips-mysty-x-12,1,1,25,13,0,72,1,3,0,0,42,662,633,1295,2133,0,0,0,17,0,97,17,97,459,2795,17,1,78,1494,0.217949,19.1538,87.8824,0.0588235,11,4.58824,2.99134,7,4.58824,1.81688,245,87.8824,81.7715,196,87.8824,80.5188,4,0.235294,0.941176,196,11.5294,46.1176,100,5.88235,23.5294,196,11.5294,46.1176,97,813,2202,0.36921,0.119311,1,51,7.3292,3.07151,20,6.91744,1.74177,102,14.6584,6.14303,40,13.8349,1.74177,1.0, /home/tomas/GitRepos/Gitforks/hapori/benchmarks/no-mystery-strips/0-prob12.pddl,97.0,459.0,3.0,5.0,1.666667,-2.0,0.0,0.497416,1.0,1.0,0.0,2.969499,0.213508,7.0,5,1,1000,1000,5,1,4,3,3,5,6,1.2,3,1,1,1.2,2,0.0,1.2,4,1.41421,2.0,0,17,0,0,0,3,5,0-prob12.pddl
no-mystery-strips,strips-mysty-x-13,1,1,83,13,0,221,2,3,0,0,42,19584,7514,27098,61437,0,0,0,76,0,1427,76,1427,17845,109545,76,2,1016,70466,0.0748031,69.3563,927.184,0.0263158,59,13.3684,16.842,47,13.3684,11.5575,8881,927.184,1876.81,8832,927.184,1701.99,7,0.184211,1.12051,762,20.0526,121.975,384,10.1053,61.4679,762,20.0526,121.975,1427,35589,105954,0.335891,0.0400967,1,258,22.5137,3.2137,224,22.2341,2.96807,615,49.7643,6.4274,538,48.8104,2.96807,1.0, /home/tomas/GitRepos/Gitforks/hapori/benchmarks/no-mystery-strips/0-prob13.pddl,1427.0,17845.0,4.0,13.0,3.25,-2.0,0.0,0.179542,1.0,1.0,0.0,2.679462,0.272625,18.0,13,1,15,13,13,2,9,8,4,14,20,1.42857,8,2,4,1.42857,4,0.0,1.42857,9,2.23607,1.0,0,76,0,0,0,46,13,0-prob13.pddl
no-mystery-strips,strips-mysty-x-14,1,1,84,13,0,233,2,3,0,0,42,47794,13610,61404,151628,0,0,0,81,0,1601,81,1601,45872,276997,81,2,1472,180448,0.0550272,122.587,2227.75,0.0246914,65,18.1728,19.0249,45,18.1728,10.293,11245,2227.75,3335.02,11088,2227.75,3066.8,9,0.222222,1.39665,2022,49.9259,313.78,1014,25.037,157.355,2022,49.9259,313.78,1593,90944,270592,0.336093,0.0175163,1,360,51.2807,4.41387,391,50.2436,4.48765,816,112.043,8.82774,857,107.895,4.48765,1.0, /home/tomas/GitRepos/Gitforks/hapori/benchmarks/no-mystery-strips/0-prob14.pddl,1601.0,45872.0,4.0,9.0,2.25,-4.0,0.0,0.173151,1.0,1.0,0.0,2.102546,0.211611,13.0,14,1,18,18,9,2,2,8,4,6,6,1.0,4,2,0,1.0,2,0.0,1.0,3,1.41421,1.0,0,81,0,0,0,44,9,0-prob14.pddl
no-mystery-strips,strips-mysty-x-15,1,1,56,13,0,163,1,3,0,0,42,17570,6412,23982,56683,0,0,0,52,0,681,52,681,16665,99326,52,1,814,62502,0.0638821,76.7838,1201.96,0.0192308,31,15.6538,7.98769,22,15.6538,4.2557,2841,1201.96,978.528,2652,1201.96,1147.9,11,0.211538,1.51069,2244,43.1538,308.18,1122,21.5769,154.09,2244,43.1538,308.18,681,32010,93192,0.343484,0.0212746,1,343,51.7472,8.34786,248,51.7472,7.45807,686,103.494,16.6957,496,103.494,7.45807,1.0, /home/tomas/GitRepos/Gitforks/hapori/benchmarks/no-mystery-strips/0-prob15.pddl,681.0,16665.0,4.0,8.0,2.0,-2.0,0.0,0.202771,1.0,1.0,0.0,1.313951,0.021962,9.0,6,1,7,6,6,1,1,4,4,2,1,0.5,1,1,0,0.5,1,0.0,0.5,1,0.0,3.0,0,52,0,0,0,11,6,0-prob15.pddl
no-mystery-strips,strips-mysty-x-16,1,1,37,13,0,103,2,3,0,0,42,2632,1504,4136,8360,0,0,0,29,0,257,29,257,2226,13619,29,2,228,8340,0.127193,36.5789,287.586,0.0689655,16,7.86207,4.07451,12,7.86207,3.76668,905,287.586,284.423,864,287.586,297.529,7,0.482759,1.77377,444,30.6207,112.508,228,15.7241,57.7742,444,30.6207,112.508,256,4355,12598,0.34569,0.058783,1,117,17.9483,3.17256,113,19.1034,2.89038,271,38.4138,6.34513,262,40.7241,2.89038,1.0, /home/tomas/GitRepos/Gitforks/hapori/benchmarks/no-mystery-strips/0-prob16.pddl,257.0,2226.0,3.0,5.0,1.666667,-4.0,0.0,0.352865,1.0,1.0,0.0,0.623091,0.098383,5.0,6,1,1000,1000,5,2,5,4,3,10,24,2.4,5,2,3,2.4,5,1.41421,2.4,6,2.44949,3.0,0,29,0,0,0,9,5,0-prob16.pddl
no-mystery-strips,strips-mysty-x-17,1,1,55,13,0,159,1,3,0,0,42,17564,6015,23579,56133,0,0,0,52,0,730,52,730,16616,99953,52,1,768,63952,0.0677083,83.2708,1229.85,0.0192308,36,14.7692,10.005,21,14.7692,4.65178,3982,1229.85,1314.12,3840,1229.85,1294.64,9,0.173077,1.23602,1542,29.6538,211.771,774,14.8846,106.297,1542,29.6538,211.771,730,32504,95728,0.339545,0.0224588,1,272,43.9679,5.35057,248,46.6603,4.9718,568,91.6282,10.7011,496,93.3205,4.9718,1.0, /home/tomas/GitRepos/Gitforks/hapori/benchmarks/no-mystery-strips/0-prob17.pddl,730.0,16616.0,3.0,4.0,1.333333,-2.0,0.0,0.138485,1.0,1.0,0.0,0.667309,0.0,1.0,5,1,4,4,5,1,1,4,3,2,1,0.5,1,1,0,0.5,1,0.0,0.5,1,0.0,1.0,0,52,0,0,0,20,5,0-prob17.pddl
no-mystery-strips,strips-mysty-x-18,1,1,50,13,0,159,1,3,0,0,42,3820,2316,6136,12211,-1,-1,-1,1,0,2,0,0,0,4,1,1,0,0, ?, ?,0.0,1.0,0,0.0,0.0,0,0.0,0.0,0,0.0,0.0,0,0.0,0.0,0,0.0,0.0,0,0.0,0.0,0,0.0,0.0,0,0.0,0.0,0,0,0, ?, ?, ?,0, ?, ?,0, ?, ?,0, ?,,0,, ?,,,,,,,,,,,,,,,,,1000,1000,1000,1000,1000,1,1000,1000,1000,2,1,0.5,1,1,0,0.5,1,0.0,0.5,1,0.0,,0,0,1,0,0,0,0,0-prob18.pddl
no-mystery-strips,strips-mysty-x-19,1,1,47,13,0,138,1,3,0,0,42,7178,3181,10359,22977,0,0,0,41,0,465,41,465,6521,39709,41,1,437,25306,0.0938215,57.9085,617.22,0.0243902,25,10.6585,6.56528,15,10.6585,5.01028,2243,617.22,688.228,2184,617.22,699.492,8,0.195122,1.23406,882,21.5122,136.055,444,10.8293,68.4903,882,21.5122,136.055,465,12861,37986,0.338572,0.0361558,1,321,35.8972,3.77369,319,37.2448,3.58157,866,89.4469,7.54738,862,92.142,3.58157,1.0, /home/tomas/GitRepos/Gitforks/hapori/benchmarks/no-mystery-strips/0-prob19.pddl,465.0,6521.0,3.0,6.0,2.0,-2.0,0.0,0.217513,1.0,1.0,0.0,0.728876,0.12038,7.0,5,1,7,6,5,1,1,4,3,2,1,0.5,1,1,0,0.5,1,0.0,0.5,1,0.0,3.0,0,41,0,0,0,14,5,0-prob19.pddl
no-mystery-strips,strips-mysty-x-20,1,1,49,13,0,155,1,3,0,0,42,7768,4174,11942,25710,0,0,0,42,0,462,42,462,7094,40757,42,1,478,22828,0.0878661,47.7573,543.524,0.0238095,22,11.381,6.47321,21,11.381,5.30028,1139,543.524,428.179,2166,543.524,600.209,11,0.261905,1.67701,2166,51.5714,330.218,1086,25.8571,165.566,2166,51.5714,330.218,462,12488,33616,0.37149,0.0369955,1,145,26.2776,6.1743,132,26.1585,5.72796,290,52.5551,12.3486,264,52.317,5.72796,1.0, /home/tomas/GitRepos/Gitforks/hapori/benchmarks/no-mystery-strips/0-prob20.pddl,462.0,7094.0,4.0,10.0,2.5,-2.0,0.0,0.286794,1.0,1.0,0.0,3.213279,0.136876,12.0,7,1,7,7,7,1,1,5,4,2,1,0.5,1,1,0,0.5,1,0.0,0.5,1,0.0,8.0,0,42,0,0,0,4,7,0-prob20.pddl
no-mystery-strips,strips-mysty-x-21,1,1,59,13,0,152,1,3,0,0,42,6456,3022,9478,19964,0,0,0,52,0,680,52,680,5557,34298,52,1,576,21314,0.0902778,37.0035,409.885,0.0192308,41,11.0769,12.2158,35,11.0769,9.12698,3694,409.885,778.182,3672,409.885,704.202,6,0.115385,0.824011,312,6.0,42.8486,162,3.11538,22.2483,312,6.0,42.8486,680,11085,32370,0.342447,0.0613442,1,285,16.3953,1.07476,268,15.9386,1.14782,678,40.8611,2.57818,632,39.2265,1.14782,1.0, /home/tomas/GitRepos/Gitforks/hapori/benchmarks/no-mystery-strips/0-prob21.pddl,680.0,5557.0,3.0,4.0,1.333333,-2.0,0.0,0.179869,1.0,1.0,0.0,0.415512,0.047148,7.0,4,1,1000,1000,4,1,4,3,3,5,6,1.2,3,1,1,1.2,2,0.0,1.2,4,1.41421,8.0,0,52,0,0,0,6,4,0-prob21.pddl
no-mystery-strips,strips-mysty-x-22,1,1,65,13,0,208,1,3,0,0,42,19744,7280,27024,63161,0,0,0,66,0,957,66,957,18514,111615,66,1,1102,71156,0.0598911,64.5699,1078.12,0.0151515,29,16.697,7.40182,30,16.697,9.3192,2698,1078.12,879.35,2592,1078.12,1050.76,16,0.242424,1.95449,1908,28.9091,233.073,960,14.5455,117.269,1908,28.9091,233.073,957,36173,106474,0.339736,0.0264562,1,162,38.2754,5.21247,223,42.2148,5.1408,324,76.5508,10.4249,446,84.4296,5.1408,1.0, /home/tomas/GitRepos/Gitforks/hapori/benchmarks/no-mystery-strips/0-prob22.pddl,957.0,18514.0,5.0,10.0,2.0,-2.0,0.0,0.219242,1.0,1.0,0.0,3.513449,0.420871,24.0,10,1,1000,1000,10,1,2,6,5,4,5,1.25,2,1,1,1.25,2,0.0,1.25,3,1.0,2.0,0,66,0,0,0,18,10,0-prob22.pddl
no-mystery-strips,strips-mysty-x-23,1,1,52,13,0,157,1,3,0,0,42,8161,3621,11782,25969,0,0,0,47,0,584,47,584,7362,44938,47,1,465,28548,0.101075,61.3935,607.404,0.0212766,27,9.89362,7.77676,17,9.89362,5.31651,2385,607.404,698.977,2304,607.404,698.977,7,0.148936,1.01013,864,18.383,124.679,432,9.19149,62.3397,864,18.383,124.679,584,14460,42744,0.338293,0.0403873,1,173,22.113,3.98732,114,20.3258,3.24439,370,46.8591,7.97465,240,41.6091,3.24439,1.0, /home/tomas/GitRepos/Gitforks/hapori/benchmarks/no-mystery-strips/0-prob23.pddl,584.0,7362.0,6.0,11.0,1.833333,-2.0,0.0,0.286691,1.0,1.0,0.0,3.933985,0.3931,28.0,11,1,1000,1000,11,1,9,9,6,12,22,1.83333,7,1,4,1.83333,3,0.0,1.83333,11,3.0,8.0,0,47,0,0,0,7,11,0-prob23.pddl
no-mystery-strips,strips-mysty-x-24,1,1,69,13,0,177,3,3,0,0,42,4930,3009,7939,15055,0,0,0,54,0,758,54,758,3910,24675,54,3,322,14924,0.167702,46.3478,276.37,0.0555556,46,5.96296,10.8968,38,5.96296,7.88097,4548,276.37,757.017,4440,276.37,669.45,3,0.166667,0.687184,198,11.0,45.3542,102,5.66667,23.3643,198,11.0,45.3542,758,7736,22576,0.342665,0.0979835,1,95,7.41389,1.26552,90,7.46173,0.819717,250,16.6611,2.53104,240,16.6457,0.819717,1.0, /home/tomas/GitRepos/Gitforks/hapori/benchmarks/no-mystery-strips/0-prob24.pddl,758.0,3910.0,5.0,12.0,2.4,-2.0,0.0,0.246345,0.0,0.333333,0.471405,2.919437,0.108696,22.0,12,1,1000,1000,12,1,11,8,5,22,53,2.40909,9,3,10,2.40909,5,1.0,2.40909,19,4.12311,21.0,0,54,0,0,0,3,12,0-prob24.pddl
no-mystery-strips,strips-mysty-x-25,1,1,18,13,0,46,1,3,0,0,42,270,263,533,808,0,0,0,10,0,43,10,43,154,963,10,1,30,500,0.333333,16.6667,50.0,0.1,7,3.0,2.0,4,3.0,0.894427,125,50.0,40.7897,96,50.0,38.364,2,0.2,0.6,96,9.6,28.8,48,4.8,14.4,96,9.6,28.8,43,272,736,0.369565,0.158088,1,22,6.01667,2.12979,18,6.01667,1.82236,44,12.0333,4.25958,36,12.0333,1.82236,1.0, /home/tomas/GitRepos/Gitforks/hapori/benchmarks/no-mystery-strips/0-prob25.pddl,43.0,154.0,3.0,4.0,1.333333,-2.0,0.0,0.570597,1.0,1.0,0.0,2.597403,0.0,1.0,5,1,4,4,4,1,4,4,3,5,6,1.2,3,1,1,1.2,2,0.0,1.2,4,1.41421,1.0,0,10,0,0,0,2,4,0-prob25.pddl
no-mystery-strips,strips-mysty-x-26,1,1,31,13,0,99,1,3,0,0,42,1849,1334,3183,6104,0,0,0,23,0,174,23,174,1536,9204,23,1,140,5376,0.164286,38.4,233.739,0.0434783,15,6.08696,4.10634,10,6.08696,2.5352,666,233.739,229.994,582,233.739,253.608,5,0.217391,1.01966,582,25.3043,118.688,294,12.7826,59.9557,582,25.3043,118.688,174,2824,7952,0.355131,0.0616147,1,63,14.3526,4.51133,61,13.0048,3.56178,126,28.7052,9.02266,122,26.0095,3.56178,1.0, /home/tomas/GitRepos/Gitforks/hapori/benchmarks/no-mystery-strips/0-prob26.pddl,174.0,1536.0,4.0,7.0,1.75,-2.0,0.0,0.371391,1.0,1.0,0.0,2.548177,0.11849,4.0,6,1,6,6,6,1,2,5,4,3,3,1.0,1,1,1,1.0,2,0.0,1.0,2,0.0,2.0,0,23,0,0,0,4,6,0-prob26.pddl
no-mystery-strips,strips-mysty-x-27,1,1,33,13,0,85,2,3,0,0,42,1446,813,2259,4448,0,0,0,19,0,152,19,152,1161,6886,19,2,99,3834,0.191919,38.7273,201.789,0.105263,14,5.21053,3.95473,7,5.21053,1.73445,639,201.789,201.375,504,201.789,155.174,3,0.315789,0.920677,252,26.5263,77.3368,126,13.2632,38.6684,252,26.5263,77.3368,152,2073,5658,0.366384,0.0733237,1,66,12.8393,0.896384,40,13.2115,1.01501,132,25.6786,1.79277,80,26.4229,1.01501,1.0, /home/tomas/GitRepos/Gitforks/hapori/benchmarks/no-mystery-strips/0-prob27.pddl,152.0,1161.0,2.0,5.0,2.5,-4.0,0.0,0.458831,1.0,1.0,0.0,0.589147,0.065461,5.0,6,1,6,6,5,2,5,4,2,7,8,1.14286,3,2,2,1.14286,2,0.0,1.14286,3,1.0,4.0,0,19,0,0,0,3,5,0-prob27.pddl
no-mystery-strips,strips-mysty-x-28,1,1,24,13,0,59,2,3,0,0,42,366,334,700,1024,0,0,0,14,0,78,14,78,194,1282,14,2,32,668,0.4375,20.875,47.7143,0.142857,13,2.28571,3.34725,8,2.28571,1.8681,334,47.7143,85.7275,280,47.7143,66.2511,1,0.142857,0.349927,40,5.71429,13.9971,20,2.85714,6.99854,40,5.71429,13.9971,78,357,994,0.359155,0.218487,1,29,3.93861,0.390207,25,3.98146,0.264845,66,8.37721,0.780414,56,8.3915,0.264845,1.0, /home/tomas/GitRepos/Gitforks/hapori/benchmarks/no-mystery-strips/0-prob28.pddl,78.0,194.0,4.0,8.0,2.0,-2.0,0.0,0.5547,1.0,1.0,0.0,4.64433,0.603093,10.0,11,1,12,10,8,2,8,6,4,13,30,2.30769,5,2,6,2.30769,6,1.73205,2.30769,8,2.44949,5.0,0,14,0,0,0,1,7,0-prob28.pddl
no-mystery-strips,strips-mysty-x-29,1,1,34,13,0,86,2,3,0,0,42,1534,892,2426,4719,0,0,0,22,0,177,22,177,1224,7554,22,2,96,4560,0.229167,47.5,207.273,0.0909091,19,4.36364,5.29619,12,4.36364,2.7887,1140,207.273,324.587,1056,207.273,278.763,2,0.181818,0.57496,192,17.4545,55.1961,96,8.72727,27.5981,192,17.4545,55.1961,177,2352,6816,0.34507,0.0752551,1,74,10.6595,1.75349,60,11.2277,1.46244,166,22.9553,3.50699,138,24.0917,1.46244,1.0, /home/tomas/GitRepos/Gitforks/hapori/benchmarks/no-mystery-strips/0-prob29.pddl,177.0,1224.0,3.0,4.0,1.333333,-1.0,0.0,0.212598,0.0,0.5,0.5,1.176471,0.0,0.0,5,1,5,4,5,1,4,4,3,6,6,1.0,2,2,2,1.0,2,0.0,1.0,4,1.41421,9.0,0,22,0,0,0,2,4,0-prob29.pddl
no-mystery-strips,strips-mysty-x-30,1,1,42,13,0,123,3,3,0,0,42,4582,2124,6706,14587,0,0,0,30,0,319,30,319,4085,23826,30,3,240,13630,0.125,56.7917,454.333,0.1,21,8.0,5.85947,13,8.0,3.0,1363,454.333,441.667,1092,454.333,391.42,5,0.5,1.5,780,78.0,234.0,390,39.0,117.0,780,78.0,234.0,319,7290,20040,0.363772,0.0437586,1,70,19.6935,4.03572,72,20.7768,3.62028,140,39.3869,8.07144,144,41.5536,3.62028,1.0, /home/tomas/GitRepos/Gitforks/hapori/benchmarks/no-mystery-strips/0-prob30.pddl,319.0,4085.0,3.0,11.0,3.666667,-3.0,0.0,0.403744,0.0,0.666667,0.471404,0.888617,0.296206,17.0,11,1,12,10,10,2,2,5,3,5,2,0.4,2,3,0,0.4,1,0.0,0.4,1,0.0,3.0,0,30,0,0,0,5,10,0-prob30.pddl
